AAACAAGTATCTCCCA	Olfactory_area
AAACAATCTACTAGCA	Isocortex_1
AAACACCAATAACTGC	Midbrain
AAACAGAGCGACTCCT	Isocortex_1
AAACCGGGTAGGTACC	Midbrain
AAACCGTTCGTCCAGG	Midbrain
AAACCTCATGAAGTTG	Midbrain
AAACGAAGAACATACC	Isocortex_1
AAACGAGACGGTTGAT	Hippocampus_area
AAACGGTTGCGAACTG	Hippocampus_area
AAACTCGGTTCGCAAT	Olfactory_area
AAACTGCTGGCTCCAA	Hippocampus_area
AAACTTGCAAACGTAT	Midbrain
AAAGACCCAAGTCGCG	Isocortex_2
AAAGGCCCTATAATAC	Hypothalamus
AAAGGCTACGGACCAT	Cortical_subplate
AAAGGCTCTCGCGCCG	Hippocampus_area
AAAGGGATGTAGCAAG	Hippocampus_area
AAAGGGCAGCTTGAAT	CA1_CA2
AAAGTAGCATTGCTCA	Thalamus
AAAGTCACTGATGTAA	Isocortex_2
AAAGTCGACCCTCAGT	Midbrain
AAAGTGTGATTTATCT	Isocortex_2
AAAGTTGACTCCCGTA	Isocortex_2
AAATAACCATACGGGA	Isocortex_1
AAATACCTATAAGCAT	Hippocampus_area
AAATAGCTTAGACTTT	Hippocampus_area
AAATAGGGTGCTATTG	Olfactory_area
AAATCGTGTACCACAA	Midbrain
AAATCTAGCCCTGCTA	Olfactory_area
AAATGCTCGTTACGTT	Hippocampus_area
AAATGGCATGTCTTGT	Isocortex_2
AAATGGCCCGTGCCCT	Midbrain
AAATGGTCAATGTGCC	Thalamus
AAATTAACGGGTAGCT	Thalamus
AAATTACACGACTCTG	Isocortex_1
AAATTACCTATCGATG	Isocortex_2
AAATTGATAGTCCTTT	Midbrain
AAATTGCGGCGGTTCT	Isocortex_2
AAATTTGCGGGTGTGG	Thalamus
AACAACTGGTAGTTGC	Hippocampus_area
AACAATACATTGTCGA	Hypothalamus
AACAATTACTCTACGC	Hippocampus_area
AACACACGCTCGCCGC	Olfactory_area
AACACGACTGTACTGA	Isocortex_2
AACACGAGACGCGGCC	Midbrain
AACACGCGGCCGCGAA	Isocortex_2
AACAGCTGTGTGGCAA	Hypothalamus
AACAGGAAATCGAATA	Fiber_tracts
AACAGGATGGGCCGCG	Midbrain
AACATATCAACTGGTG	Isocortex_1
AACATTGAAGTTGATC	Hypothalamus
AACATTGTGACTCGAG	Cortical_subplate
AACCAAGACTTCTCTG	Midbrain
AACCATGGGATCGCTA	Hippocampus_area
AACCCAGAGACGGAGA	Hippocampus_area
AACCCTACTGTCAATA	Isocortex_2
AACCCTGGTGGAACCA	Isocortex_1
AACCGAGCTTGGTCAT	Hippocampus_area
AACCGCTAAGGGATGC	Fiber_tracts
AACCGTTGTGTTTGCT	Isocortex_2
AACCTCGCTTTAGCCC	Olfactory_area
AACCTTTAAATACGGT	Olfactory_area
AACCTTTACGACGTCT	Isocortex_1
AACGATAATGCCGTAG	Olfactory_area
AACGATAGAAGGGCCG	Hippocampus_area
AACGATATGTCAACTG	Hippocampus_area
AACGCGAACGGCAACA	Isocortex_2
AACGCGACCTTGGGCG	Hippocampus_area
AACGCGGTCTCCAGCC	CA1_CA2
AACGCTGTTGCTGAAA	Olfactory_area
AACGGACGTACGTATA	Fiber_tracts
AACGGCCATCTCCGGT	Thalamus
AACGTACTGTGGGTAC	Hippocampus_area
AACGTCAGACTAGTGG	DG
AACGTGATGAAGGACA	Isocortex_1
AACGTGCGAAAGTCTC	Hippocampus_area
AACTAGCGTATCGCAC	Isocortex_1
AACTAGGCTTGGGTGT	Cortical_subplate
AACTCAAGTTAATTGC	Thalamus
AACTCCAGAGCGTGTT	Olfactory_area
AACTCCTAATCCCATG	Isocortex_1
AACTCGATGGCGCAGT	Fiber_tracts
AACTCTCAATAGAGCG	Isocortex_2
AACTCTCAGTGTGCTC	Midbrain
AACTGATATTAGGCCT	Fiber_tracts
AACTGGGTCCCGACGT	Hippocampus_area
AACTGGTGTGGGCCTT	Isocortex_1
AACTTCTGCGTCTATC	Hippocampus_area
AACTTGCCCGTATGCA	Midbrain
AACTTGCGTTCTCGCG	Isocortex_2
AACTTTAGCTGCTGAG	Isocortex_1
AAGAAGGATCAGTTAG	Fiber_tracts
AAGACCCAACTGAACA	Cortical_subplate
AAGACTAACCCGTTGT	Isocortex_2
AAGACTGCAAGCTACT	Hippocampus_area
AAGAGATGAATCGGTA	Hippocampus_area
AAGAGCTCTTTATCGG	Hippocampus_area
AAGAGGATGTACGCGA	Midbrain
AAGAGGCATGGATCGC	Striatum
AAGATGGCACCGGACC	Hypothalamus
AAGATTGGCGGAACGT	Isocortex_2
AAGCACCCTGCGTATC	Olfactory_area
AAGCATACTCTCCTGA	Olfactory_area
AAGCCGCCGTGAAATC	Hypothalamus
AAGCGTCCCTCATCGA	Hypothalamus
AAGCTAGATCGAGTAA	Cortical_subplate
AAGCTCGTGCCAAGTC	Hippocampus_area
AAGCTCTTTCATGGTG	Olfactory_area
AAGGAGAACTTATAAG	Hippocampus_area
AAGGAGCGGTTGGTGC	Thalamus
AAGGATGAGGGACCTC	Fiber_tracts
AAGGCGCGTAAAGCTT	DG
AAGGCTGTGCTCATCG	Thalamus
AAGGGAACGACTGGCT	Hypothalamus
AAGGGACAGATTCTGT	Isocortex_2
AAGGGACTATGCATTC	Hypothalamus
AAGGTATCCTAATATA	Fiber_tracts
AAGGTGATAAACCAGC	Isocortex_2
AAGTAGAAGACCGGGT	Hippocampus_area
AAGTAGTGACGCGAGG	Thalamus
AAGTCAATTGTCGTCA	Olfactory_area
AAGTGACGACCGAATT	Midbrain
AAGTGAGTCGGGTTTA	Hippocampus_area
AAGTGCCTTGACTGTA	Olfactory_area
AAGTGCGTTAGAATCT	Thalamus
AAGTGCTTCTCTATTG	Hypothalamus
AAGTGTTTGGAGACGG	Olfactory_area
AAGTTCACTCCAAGCT	Olfactory_area
AAGTTCGGCCAACAGG	Thalamus
AAGTTTACTAATGGCA	Isocortex_1
AATAACAACGCTCGGC	Midbrain
AATAACACTAGAACAA	Midbrain
AATAAGTCCTCGAGAC	Hippocampus_area
AATACAATGTTTCAGG	Hippocampus_area
AATACCGGAGGGCTGT	Hypothalamus
AATAGAACAGAGTGGC	Midbrain
AATAGAATCTGTTTCA	Olfactory_area
AATAGTCCGTCCCGAC	Cortical_subplate
AATATCAAGGTCGGAT	Isocortex_2
AATATCGAGGGTTCTC	Isocortex_1
AATATTGGAGTATTGA	Midbrain
AATCAGACTGCAGGAC	Isocortex_2
AATCAGGTTTCATTTA	Hypothalamus
AATCATGTAAAGACTC	Olfactory_area
AATCCAAGGGCCTGAG	Fiber_tracts
AATCCATGCAAGGGTG	Fiber_tracts
AATCGCCTCAGCGCCA	Striatum
AATCGGGACACTACGA	Isocortex_2
AATCTAGGTTTACTTG	Midbrain
AATCTGCGTTGGGACG	Fiber_tracts
AATCTGGCTTTCTAGT	Midbrain
AATGACAGCAATGTCT	Thalamus
AATGACGTAGGATGTC	Striatum
AATGACTGTCAGCCGG	Hippocampus_area
AATGAGTTCGCATATG	Isocortex_2
AATGATGATACGCTAT	Isocortex_2
AATGATGCGACTCCTG	Isocortex_1
AATGCAACCGGGTACC	Hippocampus_area
AATGCACCAAGCAATG	Isocortex_1
AATGGTTCTCACAAGC	Hippocampus_area
AATGTGCCCGAGGTGT	Midbrain
AATGTGCTAATCTGAG	Hypothalamus
AATTAAAGGTCGGCGT	Thalamus
AATTAACGGATTTCCA	Olfactory_area
AATTAGCGCTGCAGCG	Cortical_subplate
AATTCATAAGGGATCT	Isocortex_2
AATTCCAAGCATGTAC	Hippocampus_area
AATTCTAGAGTTAGGC	Hippocampus_area
AATTGAACGCTCTGGT	Olfactory_area
AATTTGGGACATAGTA	Isocortex_1
AATTTGGTTCCAAAGA	Isocortex_2
ACAAACCATGCGTCCT	Hypothalamus
ACAAATCGCACCGAAT	Olfactory_area
ACAAATGGTAGTGTTT	Olfactory_area
ACAACAGCATGAGCTA	Hippocampus_area
ACAACGGTCCCTGCGA	Hippocampus_area
ACAAGCAGTGCCTAGC	Midbrain
ACAAGGAAATCCGCCC	Striatum
ACAAGGACAAGAGGTT	Thalamus
ACAAGGATGCTTTAGG	Olfactory_area
ACAAGGGCAGGCTCTG	Striatum
ACAATAGTCGTACGTT	Midbrain
ACAATCCATTTAAACC	Midbrain
ACAATGAATACGGAGA	Hypothalamus
ACAATTGTGTCTCTTT	Olfactory_area
ACAATTTGAGCAGTGG	Fiber_tracts
ACACAAAGACGGGTGG	Hippocampus_area
ACACACCAGGACCAGT	Fiber_tracts
ACACACTTTCTACACG	Fiber_tracts
ACACATGATCAAATCT	Midbrain
ACACCCAGCATGCAGC	Hippocampus_area
ACACCCGAGAAATCCG	Hippocampus_area
ACACCGGTCTGACCGC	Hypothalamus
ACACCTTAAGTAGGGC	DG
ACACGAGACTCCTTCT	Hippocampus_area
ACACGGCACTATGCAT	Isocortex_1
ACACGGGAACTTAGGG	Hippocampus_area
ACACTCCAATGTCACT	Isocortex_2
ACACTGATCAAGGTGT	Midbrain
ACAGAACTGAGAACAA	Thalamus
ACAGATTAGGTTAGTG	Isocortex_1
ACAGCATAGAGCCAGT	Isocortex_2
ACAGCGCACCCGCAGC	Isocortex_1
ACAGGCTTGCCCGACT	Fiber_tracts
ACAGGTGGAGGTGAGG	Midbrain
ACATAATAAGGCGGTG	CA1_CA2
ACATCCCGGCCATACG	Cortical_subplate
ACATCCTGGTAACTGT	Isocortex_1
ACATCGATCGTTTACC	Midbrain
ACATCGGTCAGCCGCG	Thalamus
ACATCGTATGCAATGG	Olfactory_area
ACATCGTTAACCTAGT	Isocortex_1
ACATGGCGCCAAAGTA	Olfactory_area
ACATTAGTTTATATCC	Hippocampus_area
ACCAACGCTTATTTAT	Midbrain
ACCAAGAACGCGTGTC	CA1_CA2
ACCAATATGCAAGTTA	Olfactory_area
ACCACAACTCAGAACA	Hippocampus_area
ACCACAAGTTTCTATC	Thalamus
ACCACGTGCAGCTATA	Olfactory_area
ACCAGGAGTGTGATCT	Isocortex_1
ACCAGTGCGGGAGACG	Olfactory_area
ACCATATCCGCAATAA	Hippocampus_area
ACCATCGTATATGGTA	Thalamus
ACCCAACGCCCGTGGC	Fiber_tracts
ACCCACCTACATGCTC	Hippocampus_area
ACCCATCTTGAGGGTA	Thalamus
ACCCGAGCGAAATTAC	Hypothalamus
ACCCGATTGGTTCCGA	Hypothalamus
ACCCGGAAACTCCCAG	Olfactory_area
ACCCGGATGACGCATC	Isocortex_1
ACCCGGTTACACTTCC	Thalamus
ACCCGTGTCATCAGTA	Cortical_subplate
ACCCTATAGGACTGAG	Isocortex_2
ACCCTATGCCATATCG	Hypothalamus
ACCCTCCCTTGCTATT	Olfactory_area
ACCCTTCATCTGCGAA	Isocortex_2
ACCGAAAGGGCCCTGC	Isocortex_2
ACCGACACATCTCCCA	Olfactory_area
ACCGACTGAGTCCCAC	Hippocampus_area
ACCGATGGTAGCATCG	Isocortex_2
ACCGCAATAACTGCCT	Olfactory_area
ACCGCGGTGGAAGTCG	Hippocampus_area
ACCGGGCCTTTGTTGA	Isocortex_2
ACCGGTCAGGTACACC	Midbrain
ACCGTGACCACGTGGG	Hypothalamus
ACCGTTCCCGCTCTGA	Isocortex_1
ACCTAAGTACCTTTCA	Midbrain
ACCTAATCGACTTCCT	Thalamus
ACCTCGAACTTATGCT	Hypothalamus
ACCTGCGTGTCATGTT	Midbrain
ACGAAATGGGCGGCAC	Midbrain
ACGACTGGTCATACTC	Hypothalamus
ACGAGAACCCATCACG	Isocortex_2
ACGAGATATTTGCTTA	Isocortex_1
ACGAGGATACCACTCT	Midbrain
ACGATACATAGAACTA	Fiber_tracts
ACGATCATACATAGAG	Hippocampus_area
ACGATCATCTTGTAAA	Isocortex_1
ACGATGCATATGTTAT	Thalamus
ACGATGGATCCGATGC	Isocortex_2
ACGCAAACTAATAGAT	Hippocampus_area
ACGCATTCGTGAGTAC	Hippocampus_area
ACGCCAGATGATTTCT	Fiber_tracts
ACGCCGCTAGACGACC	Hippocampus_area
ACGCGAAGTCAGACGA	Hippocampus_area
ACGCGCTACACAGGGT	Midbrain
ACGCGGGCCAAGGACA	Hippocampus_area
ACGCTAGTGATACACT	Isocortex_1
ACGGAATTTAGCAAAT	Hippocampus_area
ACGGACTCTCAAAGCG	Olfactory_area
ACGGATGGTGCGGATA	Olfactory_area
ACGGCACTTGCTTGGG	Hippocampus_area
ACGGCCAACATGGACT	Hippocampus_area
ACGGCGACGATGGGAA	Olfactory_area
ACGGCGGGTTGCCCTG	Isocortex_2
ACGGGAGTGTCGGCCC	Thalamus
ACGGTCACCGAGAACA	Hypothalamus
ACGTACAGATTTCTCT	Isocortex_2
ACGTACTTTGGCACGG	Hypothalamus
ACGTAGATTGCTGATG	Hippocampus_area
ACGTATTACTCCGATC	Isocortex_2
ACGTGCGCCTCGTGCA	Fiber_tracts
ACGTTAATGTCGAAGA	Hippocampus_area
ACGTTAGATTTGCCCG	Thalamus
ACGTTCCGCGCTCCGT	Isocortex_2
ACGTTCGTTCAGGAAA	Hypothalamus
ACGTTTAGTTGTGATC	Isocortex_2
ACTACATCCCGACAAG	Hypothalamus
ACTACCAGCTCTCTGG	DG
ACTACGCGTTAGAATT	Cortical_subplate
ACTAGTTGCGATCGTC	Olfactory_area
ACTATGTCCAGCTGCC	Hypothalamus
ACTATTCGTCCGTGGT	Isocortex_2
ACTATTTCCGGGCCCA	Hypothalamus
ACTCAACGAATGTATT	Isocortex_2
ACTCAAGTGCAAGGCT	Olfactory_area
ACTCAATAAAGGCACG	CA3
ACTCAGACCTGCTTCT	Isocortex_2
ACTCATGGCAGCCTTC	Hypothalamus
ACTCCAATATCATCAT	Hypothalamus
ACTCCCATTCCTAAAG	Midbrain
ACTCCCGAATTCGTTT	Isocortex_1
ACTCCCTAATGCTAAA	Olfactory_area
ACTCCCTAGAATAGTA	Cortical_subplate
ACTCGTAACCCGTCCT	Thalamus
ACTCGTCAGTAATCCC	Hippocampus_area
ACTCTCTGACTTAGGT	Striatum
ACTCTCTTATACACGA	Hippocampus_area
ACTCTTGTATAGTAAC	Hippocampus_area
ACTGAAACGCCGTTAG	Olfactory_area
ACTGAATGGCGAAAGT	Olfactory_area
ACTGCCCGCCATTCTC	Hypothalamus
ACTGCCGTCGTAACTC	Fiber_tracts
ACTGTACGATACACAT	Hippocampus_area
ACTGTAGCACTTTGGA	Hippocampus_area
ACTGTATACGCGAGCA	Isocortex_2
ACTGTCCAGGATTATA	Thalamus
ACTGTCTTCTTTAGAA	CA3
ACTGTGCTAGTAGATC	Fiber_tracts
ACTTACCGGGCGCGCA	Hippocampus_area
ACTTACGCATCCACGC	Olfactory_area
ACTTAGTACGACAAGA	Hippocampus_area
ACTTATACTTACCCGG	Fiber_tracts
ACTTATCTGATCTATA	Isocortex_1
ACTTATTAGGATCGGT	Thalamus
ACTTATTTATGTGCCA	Fiber_tracts
ACTTCAGGCTGATCCC	Olfactory_area
ACTTCCATGCGGGACA	Olfactory_area
ACTTCGCCATACGCAC	Hippocampus_area
ACTTGACTCCCTCTTT	Hippocampus_area
ACTTGCCATATTGTAC	Isocortex_1
ACTTGGGACCCGGTGG	Thalamus
ACTTTACCCTCATGAA	Isocortex_1
ACTTTCCTATAGCTTC	Hippocampus_area
AGAACGTGGTACATTC	Hippocampus_area
AGAAGAGCGCCGTTCC	Olfactory_area
AGAAGGTTGCCGAATT	Thalamus
AGAAGGTTGTAGGTCG	Olfactory_area
AGAAGTGATTCGTGAT	Thalamus
AGAATTATGGATTCGA	Isocortex_2
AGAATTGTTTGACATA	Hippocampus_area
AGACATAGATCCTTCC	Isocortex_2
AGACCATGGGATACAA	CA1_CA2
AGACCCACCGCTGATC	Hippocampus_area
AGACCCGCCCTCCTCG	Hippocampus_area
AGACCGGGAAACCCTG	Midbrain
AGACGAAGTGCCGGTC	Isocortex_2
AGACGACGATGCCGCT	Midbrain
AGACTAGCCTTCCAGA	Thalamus
AGACTGTTACCGGGTC	Hippocampus_area
AGAGAAACACCAGAAA	Hypothalamus
AGAGAACCGTCTAGGA	Isocortex_2
AGAGAAGGAGTACAAT	Hypothalamus
AGAGATCTCTAAAGCG	Midbrain
AGAGCAGTTATGAGAC	Hippocampus_area
AGAGCGGGCTAATCAT	Fiber_tracts
AGAGCGTACAAGCTCG	Hippocampus_area
AGAGGCTTCGGAAACC	Olfactory_area
AGAGGTATCTCGGTCC	Isocortex_1
AGAGTAAACTTCACTA	Olfactory_area
AGATAACTTCAGGGCC	Thalamus
AGATACCGGTGTTCAC	Thalamus
AGATACGACTTCATAT	Hippocampus_area
AGATACTCAAGATCGA	Olfactory_area
AGATATAATACGACTA	Olfactory_area
AGATCGTGCATAAGAT	Isocortex_1
AGATCTCAGGTGTGAT	Hippocampus_area
AGATGACTCGCCCACG	Hippocampus_area
AGATGATGGAGTCTGG	Hippocampus_area
AGATGCAAGACGTGCA	Midbrain
AGATTATAGGACGTTT	Thalamus
AGCAAAGGCCGCTAGT	Olfactory_area
AGCAACATATCTTATT	Isocortex_2
AGCAACCGAAAGTAAT	Hypothalamus
AGCACACGTTTAGACT	Hypothalamus
AGCACCAGTACTCACG	Hippocampus_area
AGCACTACCGGCCTGT	Midbrain
AGCACTACCTCACCAG	Olfactory_area
AGCACTTAAGGACGCC	Thalamus
AGCAGAAGGAGAAAGA	Olfactory_area
AGCAGCCAGATGAATA	Cortical_subplate
AGCATATCAATATGCT	Olfactory_area
AGCATCATTTCGAAAG	Midbrain
AGCATCGTCGATAATT	Hippocampus_area
AGCCAAGCTTTGTGTC	Cortical_subplate
AGCCACTCCCGTGCTT	Fiber_tracts
AGCCCATACATGTAAG	Midbrain
AGCCCGGCATTAGAGG	Hypothalamus
AGCCCGGTAGCCTGTA	Hippocampus_area
AGCCCTAAGCGAAGTT	Fiber_tracts
AGCCCTCCCTGGTGGC	Hypothalamus
AGCCGTGGCTAAATGT	Thalamus
AGCGACAGGAACGGTC	Midbrain
AGCGACATCCCATTCA	Hippocampus_area
AGCGACCAACGATATT	Hippocampus_area
AGCGAGACGTGAAGGC	Hypothalamus
AGCGCATAATGAATCG	Cortical_subplate
AGCGCGGGTGCCAATG	Isocortex_2
AGCGGACACTTCGTAG	Olfactory_area
AGCGGGAAGGGTCCAT	Fiber_tracts
AGCGGGTCTGACACTC	Olfactory_area
AGCGTACGAGAGCTAG	Isocortex_2
AGCGTCTGAACCCGCA	Isocortex_2
AGCGTGGTATTCTACT	Hippocampus_area
AGCTAACAAGCAATGT	Hypothalamus
AGCTAGAAGCAGAAGT	Isocortex_1
AGCTATTTAATCCAAC	Isocortex_2
AGCTCCTTCGCACATC	Olfactory_area
AGCTCTAGACGTTCCA	Hippocampus_area
AGCTCTTCCCAGTGCA	Isocortex_2
AGCTCTTTACTCAGTT	Thalamus
AGCTGAAGTAAACCAA	Isocortex_2
AGCTGTAACCTCAATC	Midbrain
AGCTTATAGAGACCTG	Isocortex_1
AGCTTGATCTTAACTT	Midbrain
AGGAAGCTGTCCGCCG	Olfactory_area
AGGACAGTCGAATCCC	Olfactory_area
AGGACATCGCACGTCG	CA1_CA2
AGGACGACCCATTAGA	Thalamus
AGGACGCTCGATGTTG	Isocortex_1
AGGAGGCCTTCGCGCG	Olfactory_area
AGGATAAAGTCGGGAT	Cortical_subplate
AGGATATAGGGATTTA	Isocortex_2
AGGATCACGCGATCTG	Midbrain
AGGCAGATGCGTAAAC	Fiber_tracts
AGGCAGGGAGCGTACT	Hippocampus_area
AGGCATTGTCGTAGGG	Olfactory_area
AGGCCACCCGTTATGA	Hippocampus_area
AGGCCCATTGTACAGG	Hippocampus_area
AGGCCCTAGAACGCCA	Midbrain
AGGCCTGAGAATCTCG	Olfactory_area
AGGCGGTTTGTCCCGC	Midbrain
AGGCTATGGTTAGCTT	Hippocampus_area
AGGCTTCCCGAAGAAG	Midbrain
AGGCTTGCTAGACACC	Hippocampus_area
AGGGAAACGAGGTACT	Isocortex_1
AGGGACAGCACGGCGG	Isocortex_1
AGGGACTCTACGCGAC	Hippocampus_area
AGGGCAGCGGCGTGGT	Isocortex_1
AGGGCGAGCAGCTGAT	Midbrain
AGGGCGTGATCGGCTA	CA1_CA2
AGGGCTGCAGTTACAG	Hippocampus_area
AGGGTCGATGCGAACT	Isocortex_2
AGGGTGCCGTTCTTTA	Hypothalamus
AGGGTGCTCTCGAGGG	Isocortex_2
AGGGTTCCCTTTGGTT	Fiber_tracts
AGGGTTTAGTTCGGGA	Hippocampus_area
AGGTAACCTCCTATTC	Fiber_tracts
AGGTACGATATTGCCA	Isocortex_2
AGGTAGATCGAGATAT	Hypothalamus
AGGTAGGTACAAAGCT	Midbrain
AGGTCAGGTGAGAGTG	Midbrain
AGGTGGTGACCTTCGC	Cortical_subplate
AGGTGTATCGCCATGA	Midbrain
AGGTTGAGGCACGCTT	Fiber_tracts
AGGTTTCACACACCTT	Hippocampus_area
AGTAATGTCTTGCCGC	Hippocampus_area
AGTACGGGCACCTGGC	Fiber_tracts
AGTACTCTTATGCCCA	Olfactory_area
AGTAGGTAACATACAT	Fiber_tracts
AGTATAATACTAGGCA	Hippocampus_area
AGTATACACAGCGACA	Hippocampus_area
AGTATCCATAATAACG	Isocortex_2
AGTATGCTGGAGACCA	Hypothalamus
AGTATTTGGCACGACC	Hippocampus_area
AGTCAAATGATGTGAT	Hypothalamus
AGTCAACACCACCATC	Thalamus
AGTCAAGATGACACTT	Fiber_tracts
AGTCACTAGCTCTCGA	Olfactory_area
AGTCACTCCGCCTCAT	Isocortex_2
AGTCAGCCACCGCCTG	Hippocampus_area
AGTCCATTGGCTGATG	Isocortex_2
AGTCCCGCCTTTAATT	Isocortex_1
AGTCGACGGTCTCAAG	Fiber_tracts
AGTCGGCCCAAACGAC	DG
AGTCGGCTCAACTTTA	Thalamus
AGTCGTCGACCACCAA	Olfactory_area
AGTCGTGGGCATTACG	Thalamus
AGTCTCACAAGACTAC	Midbrain
AGTCTGGACATCCTTG	Hippocampus_area
AGTCTTCTCCTCAAAT	CA1_CA2
AGTGAACAAACTTCTC	Isocortex_1
AGTGACCTACTTTACG	Thalamus
AGTGACTGTGACACAA	Hypothalamus
AGTGAGACTTCCAGTA	Fiber_tracts
AGTGAGCCTCGCCGCC	Isocortex_1
AGTGATAACCTGCGCG	Olfactory_area
AGTGATATGAGTAGTT	Thalamus
AGTGATTCAAGCAGGA	Fiber_tracts
AGTGCACGCTTAAGAA	Olfactory_area
AGTGCGTAGCTCGTAA	Thalamus
AGTGCTAAACACAGCA	Olfactory_area
AGTGCTTGCACGAATA	Fiber_tracts
AGTGGCGGCAATTTGA	Isocortex_2
AGTGGCGTCTGAAGGT	Olfactory_area
AGTGTATTGCGCATTG	Isocortex_1
AGTGTGGTCTATTGTG	Hippocampus_area
AGTTAAACACTTGCGA	Thalamus
AGTTAAGCGGTCCCGG	Isocortex_2
AGTTAAGTCAACCGCT	Midbrain
AGTTACTCTATCGTGG	Isocortex_1
AGTTCCTACAGAATTA	Thalamus
AGTTCCTATTTATGTT	Hippocampus_area
AGTTCTGCGTTGTATC	Isocortex_2
AGTTGACATCGGCTGG	Fiber_tracts
AGTTGACGGTCCTTGC	Olfactory_area
AGTTGCTGACTGATAT	Isocortex_2
AGTTTCGCAGGTCGGA	Isocortex_2
AGTTTGCACCTGCCTC	Olfactory_area
AGTTTGGCACGGGTTG	Olfactory_area
AGTTTGGCCAGACCTA	Thalamus
ATAAACCATTGGACGG	Isocortex_1
ATAAACGGACCCGTAA	Hippocampus_area
ATAAAGGCTCGGTCGT	Thalamus
ATAAATATTAGCAGCT	Midbrain
ATAACGCCGGAGGGTC	Striatum
ATAACGGAGTCCAACG	Hippocampus_area
ATAAGGTGGAGAACAT	Cortical_subplate
ATAAGTTACCGCGACG	Midbrain
ATAATAGCTGTTGAAT	Hippocampus_area
ATAATAGTGTAGGGAC	Hippocampus_area
ATAATCTTGGAGAACC	Olfactory_area
ATAATTAGCTAAGTAG	Olfactory_area
ATACAGGCCCTCCAAT	Olfactory_area
ATACCACGGGCAACTT	Midbrain
ATACCAGCAAATTGCT	Isocortex_1
ATACCAGGCTAATAGA	Isocortex_2
ATACCTAACCAAGAAA	Olfactory_area
ATACGCCGATCTACCG	Isocortex_1
ATACGCCGGCGAAACC	Hippocampus_area
ATACGGAACGTCGTTT	Hypothalamus
ATACGGGTTTCGATTG	Fiber_tracts
ATACGTACTTAGCCAC	Olfactory_area
ATACGTCCACTCCTGT	Isocortex_2
ATACGTTATGCACGGA	Olfactory_area
ATACTAGCATGACCCT	CA1_CA2
ATACTCTCGCCACTCT	Fiber_tracts
ATACTGCCTTACACCG	Olfactory_area
ATAGACAACGGGACCT	Isocortex_2
ATAGACGAAGAGAAAG	Thalamus
ATAGAGTACTGGGACA	CA3
ATAGAGTTATCAACTT	Isocortex_2
ATAGGCGGCTATAGAA	Thalamus
ATAGGCTAGCTTCGCA	Isocortex_1
ATAGGGATATCCTTGA	Hippocampus_area
ATAGGTTGGGCAGATG	Hippocampus_area
ATAGTCTTTGACGTGC	Isocortex_1
ATAGTGAAGCGTTCTC	Midbrain
ATAGTTCCACCCACTC	Isocortex_1
ATATAAAGCGCTCGTG	Olfactory_area
ATATAAATGTAGCTGC	Olfactory_area
ATATCAACCTACAGAG	Olfactory_area
ATATCGTTCCTCGAAC	Olfactory_area
ATATCTCCCTCGTTAA	Isocortex_2
ATATCTTAGGGCCTTC	Midbrain
ATATGTCTCCCTAGCC	Isocortex_2
ATATTCAGTTAAACCT	Thalamus
ATATTCCACATAGTGA	Olfactory_area
ATATTCCCACAGGTCA	Isocortex_2
ATATTGCTGTCAAAGT	Hippocampus_area
ATATTTAACCCTCAAG	Thalamus
ATCAAACACTGTTCCA	Hippocampus_area
ATCAAACGAAGGTTTG	Thalamus
ATCAATCTGGGCTGCA	Hippocampus_area
ATCAATGCCGTGGCTG	Hypothalamus
ATCACATTAGAATATC	Isocortex_2
ATCACGTGCTAATTAA	Thalamus
ATCACTTCATCCTCGC	Hippocampus_area
ATCAGACGGCACGCCG	Thalamus
ATCAGCCTCATGCTGC	Olfactory_area
ATCAGTAGGCAGGGAT	Isocortex_2
ATCATCCAATATTTGT	Midbrain
ATCCAACGCAGTCATA	DG
ATCCAATGGAGGGTCC	Midbrain
ATCCACATCGACAGAA	Olfactory_area
ATCCAGAGCAACAACC	Midbrain
ATCCAGGATTCGTGAA	Thalamus
ATCCTACCTAAGCTCT	Thalamus
ATCCTGAATCGCTGCG	Midbrain
ATCCTGCGTGGAATGG	Thalamus
ATCCTGCTGCAGATAG	Isocortex_1
ATCGACCCAATACAGA	Midbrain
ATCGACTCTTTCCGTT	Hippocampus_area
ATCGCACGATTGTTCA	Isocortex_2
ATCGCACGCCGGGAGA	Hippocampus_area
ATCGCCAGTCAACATT	Olfactory_area
ATCGGAGACAGACGGC	Olfactory_area
ATCGGCAAGCAGTCCA	Isocortex_1
ATCGTGGAAAGTCTGG	Hypothalamus
ATCTAATATCCTACGG	Olfactory_area
ATCTAGCTTGTGAGGG	Olfactory_area
ATCTCCCTGCAATCTA	Fiber_tracts
ATCTGACATGGAAGGA	Hypothalamus
ATCTGCACCTCTGCGA	Isocortex_1
ATCTGCTGTTATCGCC	Hippocampus_area
ATCTGGGCTGTTCTTG	Olfactory_area
ATCTGGTTAAGACTGT	Hippocampus_area
ATCTGTAATTGTACCC	Fiber_tracts
ATCTTGACCTGCAACG	DG
ATGAAGCCAAGGAGCC	Hippocampus_area
ATGACGCCGGCTCTAA	Hippocampus_area
ATGACGCGTTCTATCC	Midbrain
ATGACTATCAGCTGTG	Hypothalamus
ATGACTATGCGACATT	Fiber_tracts
ATGAGGAGTGTTAATC	DG
ATGATCGGGAATAGAC	Hippocampus_area
ATGATGCAATGGTACA	Thalamus
ATGCACTACCGCATTG	Hippocampus_area
ATGCATGATCCAGGAT	Hippocampus_area
ATGCATTCCGTGATGG	Isocortex_1
ATGCCATTTGCGACCA	Isocortex_2
ATGCCGGTCTTGCATA	Hippocampus_area
ATGCCGGTTGATGGGA	Isocortex_2
ATGCGACAGTCCCATT	Hippocampus_area
ATGCGAGTCCCACCAC	Olfactory_area
ATGCTCAGTGTTGCAT	CA1_CA2
ATGCTCTGGCGCGGTA	Olfactory_area
ATGGAGCAGGCCGTGA	Hippocampus_area
ATGGATCCGGCGTCCG	Fiber_tracts
ATGGATTGACCAAACG	Hippocampus_area
ATGGCAGCATTACGAT	Hypothalamus
ATGGGACCTGCTGAAC	Hypothalamus
ATGGGCCTCGGCCTCT	Isocortex_2
ATGGGTGTATACCTCC	Hypothalamus
ATGGTATTTACTGATT	Hypothalamus
ATGGTCGCGTGGTTTC	Olfactory_area
ATGTACGATGACGTCG	Olfactory_area
ATGTGAAAGCCTAATG	Midbrain
ATGTGCATCCGACGCA	Hippocampus_area
ATGTGGACATCTTGAT	Cortical_subplate
ATGTGTAGTTTAGTCA	Isocortex_1
ATGTTACGAGCAATAC	Hippocampus_area
ATGTTGTAGTCTGTTT	Hippocampus_area
ATTAAACATGCGGACC	Midbrain
ATTAATACTACGCGGG	Hippocampus_area
ATTAATGAACCAGTCG	Fiber_tracts
ATTAATTCGGTCACTC	Fiber_tracts
ATTACAACTACCGGCC	Isocortex_1
ATTACGCGCTGGCAGG	Midbrain
ATTACTAGCCTCTTGC	Hippocampus_area
ATTACTTACTGGGCAT	Isocortex_1
ATTAGATTGATAGCGG	Hippocampus_area
ATTAGGCGATGCTTTC	Hippocampus_area
ATTATACTTTGCTCGT	Isocortex_2
ATTATCTCGACAGATC	Isocortex_1
ATTATGCCATAGGGAG	Hippocampus_area
ATTATTATGTCCGTCA	Hypothalamus
ATTCACTGATGTTGGA	Olfactory_area
ATTCAGGACCTATTTC	Isocortex_1
ATTCAGTAGCAGGGTC	Hippocampus_area
ATTCATATACTGTCCA	Hippocampus_area
ATTCATCGTTGAGGCA	Olfactory_area
ATTCCCACATAAACAA	Hippocampus_area
ATTCCTCCGCCAGTGC	Hippocampus_area
ATTCCTTCCAGGCGGT	Isocortex_2
ATTCGACGCCGGGCCT	Midbrain
ATTCTCGTCTCTTTAG	Isocortex_2
ATTCTTCGTACTTATG	Isocortex_1
ATTGAAGATCTTAGTG	Thalamus
ATTGACGTAACTCGGT	Isocortex_1
ATTGATAGCAACGAGA	Isocortex_2
ATTGATGAGTCCTAAC	Isocortex_2
ATTGCCTATTAGACCG	Hypothalamus
ATTGCGATCAGTAACT	Olfactory_area
ATTGCTGCTCCTCCAT	Thalamus
ATTGGATTACAGCGTA	Olfactory_area
ATTGGGAATATCTTGG	Fiber_tracts
ATTGTACAACTCGGCT	Isocortex_1
ATTGTCGCAATACCTT	Isocortex_2
ATTTAACTCGTATTAC	Fiber_tracts
ATTTACAGTTTACTGG	Thalamus
ATTTCATTATTTCGCG	Isocortex_2
ATTTCCGGGTTCTGCG	Midbrain
ATTTGCGCGAGTAGCT	Midbrain
ATTTGTCTTGGGAGCT	Striatum
ATTTGTTCCAGGGCTC	Fiber_tracts
CAAACGAGTATCGCAG	Midbrain
CAAACGGTCGCACTTT	Thalamus
CAAACTACGATAGAGA	Isocortex_1
CAAACTATTGAGCTTC	Isocortex_2
CAAAGATTATTGGGCC	Midbrain
CAAATCTCTCACAAGG	Midbrain
CAAATGTCCTTCCGTG	Midbrain
CAAATTGTCAGCAAGC	Isocortex_2
CAACGACCCGTTTACA	Hippocampus_area
CAACGGTTCTTGATAC	Hippocampus_area
CAACTATATCGAATGC	Isocortex_2
CAACTCCTTGATCCCG	Hippocampus_area
CAACTGCTCATCCGAT	Cortical_subplate
CAACTTGTAGTGGGCA	Isocortex_2
CAAGAGGGCGGAGTAC	Striatum
CAAGATATTATAACGT	Fiber_tracts
CAAGCAACGTCGGAGT	Thalamus
CAAGCACCAAATGCCT	Hippocampus_area
CAAGCGGCACATAATT	Olfactory_area
CAAGGATCGCATGTTC	Hippocampus_area
CAAGTGAACTTTGGTT	Isocortex_1
CAAGTGTGGTTGCAAA	Isocortex_2
CAATAAACCTTGGCCC	Hippocampus_area
CAATATTCTTGACCTA	Hypothalamus
CAATATTGGACTAGTG	Isocortex_2
CAATCCCTATACCAGC	Isocortex_1
CAATCCTGCCGTGGAG	Isocortex_2
CAATGCGAGAAGTATC	Olfactory_area
CAATGGATCTCTACCA	Fiber_tracts
CAATGGTCGGCCTGGG	Isocortex_1
CAATTAAGGGTGATGA	Hippocampus_area
CAATTTCGTATAAGGG	Midbrain
CACAATGAGCTGCTAT	Thalamus
CACACAGGGATAGATT	Hippocampus_area
CACACGCGCTGTCTTA	Fiber_tracts
CACAGAGACGAGGACG	Hypothalamus
CACAGCACCCACGGCA	Hippocampus_area
CACAGCTAGGGAGTGA	CA1_CA2
CACAGGGCCATATAGT	Olfactory_area
CACAGGGCCGTTGTCA	Cortical_subplate
CACATAAGGCGACCGT	Isocortex_1
CACATATTAGCAGGAT	Striatum
CACATCGTGCACGCGC	Hypothalamus
CACATCTCACCGACGA	Olfactory_area
CACATGATTCAGCAAC	Midbrain
CACATGTTTGGACATG	Isocortex_2
CACATTCTTTCGATGG	Isocortex_2
CACCAGTCAGCATGCA	Hypothalamus
CACCATCGGAGGAGAC	Isocortex_2
CACCCAAATCTTATGT	Hippocampus_area
CACCCACACGTCACCC	CA1_CA2
CACCCACGAGGCAATT	Isocortex_2
CACCCGGTTTGTGACT	Midbrain
CACCCTAACAAGATCT	Olfactory_area
CACCCTTGGTGAGACC	Midbrain
CACCCTTTCCTCGCTC	Isocortex_2
CACCGATACACCGAGC	Isocortex_1
CACCGCCAGAAGGTTT	Hippocampus_area
CACCGCCGACCAGCGA	Isocortex_2
CACCGGTAGAGACATT	Hypothalamus
CACCGTTAGGGATCAC	Midbrain
CACCGTTGCGCGATAT	Thalamus
CACCTAATAGAGTCGT	Hippocampus_area
CACCTAATCAGTTTAC	Fiber_tracts
CACCTCGATGGTGGAC	Fiber_tracts
CACCTTGCGAAACTCG	Fiber_tracts
CACCTTGGCGCCTTTG	Isocortex_1
CACGAAAGTTAGTCCC	Midbrain
CACGACTAAAGTTCTG	Isocortex_1
CACGCACAGCGCAGCT	Hippocampus_area
CACGCAGCGAGGCTTT	Thalamus
CACGCGGAACTGTTGC	Isocortex_2
CACGTCGGCAACCTCT	Hippocampus_area
CACGTTCGTGCTCTAG	Striatum
CACGTTTCGTACACAC	Olfactory_area
CACTAAAGTTGCCTAT	Hippocampus_area
CACTCAAGAGCTATGG	Hippocampus_area
CACTCAGCTCTTGAGG	Isocortex_2
CACTCCTATGTAAGAT	Hypothalamus
CACTCCTCTCGGTCGG	Isocortex_2
CACTCGAGCTGAACAA	Striatum
CACTGACGATTGTGGA	Cortical_subplate
CACTGTCCAAGTGAGA	Hippocampus_area
CACTTAATCAGACGGA	Thalamus
CACTTCGCCACAGGCT	CA1_CA2
CAGAACTTAGCCCTCT	Olfactory_area
CAGACACCGATCGCTG	Hippocampus_area
CAGACCTGTAAGTGTT	Isocortex_1
CAGACGAACCTGATAC	Midbrain
CAGAGACGGTCACCCA	Hippocampus_area
CAGAGCATGAGCTTGC	CA3
CAGAGGCGATGCATGA	Hippocampus_area
CAGAGTGATTTAACGT	Isocortex_2
CAGATACTAACATAGT	DG
CAGATATGAAGATGAC	Hypothalamus
CAGATCCTGGTTTGAA	Midbrain
CAGCAGCCCGTTCCTT	Hippocampus_area
CAGCAGTCCAGACTAT	Olfactory_area
CAGCAGTCTGTGCTGC	Olfactory_area
CAGCCGGGCCCTCTAT	Isocortex_1
CAGCCTCCTGCAGAGG	Fiber_tracts
CAGCCTCTCCTCAAGA	Isocortex_1
CAGCGATTCCCTTCAA	Midbrain
CAGCTCACTGAGACAT	Thalamus
CAGCTCGACAAGTTAA	Isocortex_2
CAGCTCGTGCTTGTGT	Hippocampus_area
CAGCTGGCGTAACCGT	Thalamus
CAGCTTAGTAGGTAGC	Midbrain
CAGGAAGACTTTATAT	Isocortex_1
CAGGATATATCGTTGT	Midbrain
CAGGCCAGTACCACCT	Hypothalamus
CAGGCCGTTTGGGTGT	Thalamus
CAGGCGCACGGTGGTC	Midbrain
CAGGCGCCATGCTAGG	Striatum
CAGTAATCCCTCCCAG	Hippocampus_area
CAGTACCAGTTTACGT	Midbrain
CAGTAGCCCACGCGGT	Isocortex_2
CAGTCGAGGATGCAAT	Isocortex_1
CAGTCTCTCGGCTAAT	Isocortex_2
CAGTCTGTATACTGGG	Hippocampus_area
CAGTGAATAAATGACT	Fiber_tracts
CAGTGGTTGCACATGA	Isocortex_2
CAGTGTCCGCAGAATG	Hippocampus_area
CAGTGTCGGCTGGCCC	Olfactory_area
CAGTGTTAATCTCTCA	Hypothalamus
CAGTTCAAATTGACAC	Thalamus
CAGTTCCGCGGGTCGA	Hippocampus_area
CATAACGGACAGTCGT	Isocortex_2
CATAAGAAGCTTGGCT	Olfactory_area
CATAATGAGCGGGCGA	Isocortex_1
CATACAAAGCCGAACC	Fiber_tracts
CATACACGGTTCCCAC	Cortical_subplate
CATACCCGTACCCAGT	Midbrain
CATACGAACTAGCTGG	Hypothalamus
CATACGGCGTCTGGGC	Midbrain
CATACGGGTGCATGAT	Isocortex_2
CATACTATGTAATTGT	Thalamus
CATAGCCGCCCGGGAT	Hippocampus_area
CATAGCGTTGCCCACC	Midbrain
CATAGTACATTGAGAG	Isocortex_2
CATAGTAGCATAGTAG	Hippocampus_area
CATAGTCCACAAGAAC	Thalamus
CATATAGGTACAGTCA	Midbrain
CATATGTCAGGCTACG	Thalamus
CATATTATTTGCCCTA	Isocortex_1
CATCATCTACCCGGAC	Isocortex_2
CATCATTACCCTGAGG	Olfactory_area
CATCCAATATAGTTTG	Hypothalamus
CATCCTCTCAAAGATC	Olfactory_area
CATCGCCCGCGGCCAA	Hippocampus_area
CATCGGACGGGTTAAT	Midbrain
CATCTTACACCACCTC	Isocortex_2
CATGAACCGACATTTG	Isocortex_2
CATGAACCTCTTATCA	Isocortex_1
CATGAGATGCACTCTC	Olfactory_area
CATGATGCACAATTCT	Hippocampus_area
CATGATGGAAGTTAGC	Isocortex_1
CATGCATGGAGACCCT	Isocortex_1
CATGCCAACTCGCAAA	Midbrain
CATGCGACCAGTTTAA	Isocortex_1
CATGCGTTAGACAGAA	Fiber_tracts
CATGCTGGCTCCAATT	Isocortex_2
CATGGATTGTCTTCCG	Olfactory_area
CATGGCAGGAAGATCG	Hippocampus_area
CATGGGTATGCCTTAT	Olfactory_area
CATGGGTCGGGTGTGG	Isocortex_2
CATGGTAAGTAGCGTT	Striatum
CATGGTCTAGATACCG	Hippocampus_area
CATGTAAGAGACATTT	Olfactory_area
CATGTCTCATTTATGG	Olfactory_area
CATTACGTCGGCCCGT	Hippocampus_area
CATTATCCCATTAACG	Hypothalamus
CATTATGCTTGTTGTG	CA3
CATTCACTGACAGCTA	Isocortex_1
CATTCAGGTCAGTGCG	Isocortex_2
CATTCCCTAAGTACAA	Isocortex_2
CATTTAGCGGACCATG	Fiber_tracts
CATTTCTAGCAGACTA	Hippocampus_area
CATTTGAGTGGTACGT	Midbrain
CCAAACAGAACCCTCG	Hippocampus_area
CCAACCTTATGTAACT	Hypothalamus
CCAACGATGCACTGAT	Thalamus
CCAAGAAAGTGGGCGA	Hippocampus_area
CCAAGACTTCTGCGAA	Hippocampus_area
CCAAGCGTAACTCGTA	Hippocampus_area
CCAAGGAACAGAGAGG	Hippocampus_area
CCAATAGTGCCGTCGA	Thalamus
CCAATCGGTAGATCGA	Isocortex_2
CCAATGTCACAGCAAG	Thalamus
CCAATTACGGGTCGAG	Isocortex_1
CCAATTGAATGTTAAT	Hippocampus_area
CCACAATGTACGTCTT	Fiber_tracts
CCACACTGAGATATTA	Thalamus
CCACAGCTGAAATCAT	Isocortex_2
CCACAGTACCCATCCT	Fiber_tracts
CCACCAACTTTACTGT	Midbrain
CCACCCAAGGAAAGTG	Hippocampus_area
CCACGAGAAGAGAATC	Fiber_tracts
CCACGGAGCCATAAGA	Thalamus
CCACGGCAGGTGTAGG	Hypothalamus
CCACTAAACTGAATCG	Isocortex_2
CCACTGGTGGCTGGTT	Midbrain
CCAGAAAGCAACTCAT	Midbrain
CCAGAGACAAAGCCGG	Hippocampus_area
CCAGATAGTTGAGTGA	Fiber_tracts
CCAGCCTGGACCAATA	Hippocampus_area
CCAGCTACGCCTCATA	Isocortex_2
CCAGCTCGAACGCATT	Olfactory_area
CCAGCTGATGGTACTT	Hippocampus_area
CCAGGGACGTGGCCTC	CA3
CCAGTAGTCTGATCCA	Isocortex_2
CCAGTCCATTATTCGA	Isocortex_2
CCAGTCTAGACGGCGC	Isocortex_2
CCAGTCTTGTCATAGA	Cortical_subplate
CCAGTGTACAGACCGA	Hypothalamus
CCATAAACAACCCGAC	Isocortex_2
CCATACCTTTACTTGT	Isocortex_1
CCATAGGTTGGCGTGG	Hippocampus_area
CCATAGTCAGTAACCC	Isocortex_2
CCATCCATACCAAGTC	Hippocampus_area
CCATCGCAGTTAAACT	Hippocampus_area
CCATCTCACCAGTGAA	Isocortex_2
CCATCTTGTTCACAAT	Isocortex_2
CCATGCCCTAGATTTC	Olfactory_area
CCATGCCTGTTTAGTA	Thalamus
CCATGCTCTGCAGGAA	Hippocampus_area
CCATGGCCCTTGTACC	Midbrain
CCATGTTCATCTATAT	Hypothalamus
CCATTAGCGATAATCC	Thalamus
CCATTCCCTGCCCACA	Thalamus
CCATTTCTACCTATTA	Olfactory_area
CCCAAACATGCTGCTC	Fiber_tracts
CCCAACATACGTCGCG	Thalamus
CCCAACCACACTAACA	Isocortex_1
CCCAAGACAGAGTATG	Isocortex_1
CCCAATGAGATTTGCA	Hypothalamus
CCCAATTTCACAACTT	Thalamus
CCCAGTTAAGGCGCCG	Striatum
CCCGACCATAGTCCGC	Fiber_tracts
CCCGCAGCGCGAACTA	Hippocampus_area
CCCGCAGGGCCCAAAG	Isocortex_1
CCCGCCATGCTCCCGT	Hippocampus_area
CCCGCGCAATGCACCC	Hippocampus_area
CCCGGGTCGTTCAGGG	Cortical_subplate
CCCGGTGGAAGAACCT	Hippocampus_area
CCCGGTGTATCGGAAT	Midbrain
CCCGTAAGTCTAGGCC	Midbrain
CCCGTAGCTGGGAAGA	Hypothalamus
CCCGTCAGCGTCTGAC	Hippocampus_area
CCCTAGTGTCAGGTGT	Isocortex_2
CCCTATGTAGAGCAGA	Hypothalamus
CCCTCAGATCGAGAAC	Hypothalamus
CCCTCATTCTGGAATT	CA1_CA2
CCCTCGATAATACACA	Hypothalamus
CCCTGAAATGAGTTGA	Thalamus
CCCTGCCCAATCCGCT	Midbrain
CCCTGCGCTACGCATA	Midbrain
CCCTGGTATGGGCGGC	Isocortex_1
CCCTTTGACAGGTCTT	Hippocampus_area
CCGAAAGTGGTGAGCA	Hippocampus_area
CCGAACACTGGGCCTC	Midbrain
CCGAACCTTCCCGGCC	Cortical_subplate
CCGAAGTATATTGTTC	Hippocampus_area
CCGACAAAGGGAGTGC	Midbrain
CCGACGGGCATGAGGT	Midbrain
CCGAGGGATGTTAGGC	Isocortex_1
CCGATCTCAACCTTAT	Isocortex_1
CCGATTCGAGGGACCC	Midbrain
CCGCACAAAGACCAAC	Hippocampus_area
CCGCACGTGACCTCGG	Hippocampus_area
CCGCATGTGGTACGAT	Olfactory_area
CCGCCACCACAATCCA	Hippocampus_area
CCGCCGGTCAACACAC	Fiber_tracts
CCGCCTGCGAATTGGT	Hippocampus_area
CCGCGGAATGCGTCAC	Midbrain
CCGCGGGTACGAAGAA	Midbrain
CCGCGTAGGTAAGGGC	Hippocampus_area
CCGCTATCAGCACCAG	Hippocampus_area
CCGCTGGTGCCATTCA	Isocortex_1
CCGCTTACCTCACTCT	Thalamus
CCGGAATGGTTTCAGT	Hippocampus_area
CCGGAGCGTACTTTCT	Cortical_subplate
CCGGCGCATATTGGAT	Fiber_tracts
CCGGGACCCGCAGAGA	Hippocampus_area
CCGGGCGGTCTCGTCA	Hippocampus_area
CCGGGCTAAGAATTTC	Hypothalamus
CCGGGCTGCTCCATAC	Fiber_tracts
CCGGGTTCGAGGTTAC	Midbrain
CCGGTTTGTAATTGTG	Hypothalamus
CCGTAAGTTGGTCCCA	Striatum
CCGTACCCAAGCGCCA	Fiber_tracts
CCGTATCTCGTCGTAG	Thalamus
CCGTGCCCATGACGGC	Fiber_tracts
CCGTGTTAAATTCCAT	Thalamus
CCGTTACGTTAGAACA	Isocortex_2
CCGTTCCGAATCTCGG	Midbrain
CCTAAAGGCTGACGCT	Isocortex_2
CCTAAATTAACGGTTC	Hippocampus_area
CCTAACCCAAACAAGT	Fiber_tracts
CCTAACTAAGGCTCTA	Isocortex_2
CCTACATTCACAGACG	Thalamus
CCTACGGCTCAGTCGA	Hippocampus_area
CCTACTGCTTACACTT	CA3
CCTAGGCGTAGCGATC	Fiber_tracts
CCTAGTTAGTCGCATG	Isocortex_2
CCTATAATGAGTGCCC	Olfactory_area
CCTATACCGTCCTGTC	Midbrain
CCTATATTTGTCCTGG	Cortical_subplate
CCTATCTATATCGGAA	Fiber_tracts
CCTATGGCTCCTAGTG	Hypothalamus
CCTATGGGTTACCGTC	CA3
CCTATGGTCAAAGCTG	Olfactory_area
CCTCACCAATCTTGAC	CA1_CA2
CCTCACCTGAGGGAGC	Isocortex_1
CCTCACCTTAGCATCG	Isocortex_2
CCTCATGCAGCTACGA	Fiber_tracts
CCTCCCGACAATCCCT	Isocortex_2
CCTCCGACAATTCAAG	Thalamus
CCTCGAAGTGGACGGG	Isocortex_2
CCTCGCCAGCAAATTA	Fiber_tracts
CCTCGCGCGATATAGG	Isocortex_1
CCTCGCGCTGTGCGAT	Cortical_subplate
CCTCGGACCGGGATAG	Striatum
CCTCGGTTTCCTTGCC	Hypothalamus
CCTCTAATCTGCCAAG	Hippocampus_area
CCTCTACAAGGATTGG	Hypothalamus
CCTCTATCGATTAGCA	Midbrain
CCTCTCTCCCATCTAG	Thalamus
CCTCTGGCCTAGACGG	Isocortex_2
CCTCTGTACTATTCTA	Cortical_subplate
CCTGAACGATATATTC	Striatum
CCTGAATATTTACATA	Hippocampus_area
CCTGACCACCGATGGT	Hippocampus_area
CCTGAGAATAAATGCA	Hippocampus_area
CCTGCGATAGAACTGT	Isocortex_2
CCTGCTATTTGAGAAG	CA3
CCTGGCTAGACCCGCC	Thalamus
CCTGGTCGAATGTGGG	Olfactory_area
CCTGTAAGACATGATA	Thalamus
CCTGTACTCACGCCCA	Midbrain
CCTGTCACCCGGGCTC	CA3
CCTGTCGCCCGTAAAT	Midbrain
CCTGTTTGAAGACACG	Olfactory_area
CCTTCAGTTAAAGTGA	Hippocampus_area
CCTTCTTGATCCAGTG	Fiber_tracts
CCTTTAAGGGAGCACT	Hippocampus_area
CCTTTCAATGAAGAAA	Isocortex_2
CGAAACATAGATGGCA	Isocortex_2
CGAAACGCAATTCATG	Thalamus
CGAACAGTATGGGCGT	Olfactory_area
CGAACCCGCATGCGTC	Midbrain
CGAACGCCCAGTGCCG	Isocortex_2
CGAAGTTGCTCTGTGT	Thalamus
CGAATCTGCTCGACGC	Hypothalamus
CGAATGAAGTCATTGC	Hypothalamus
CGAATGACGCATAATG	Cortical_subplate
CGACAATTTGATCTAA	Isocortex_2
CGACACGCTCCGACAG	Isocortex_2
CGACAGTTCGCGTTAT	Thalamus
CGACATGCGATCTTCT	Isocortex_2
CGACTCAGGATGTTAT	Isocortex_2
CGAGACCCTAGAGTGT	Midbrain
CGAGAGATGTGAACCT	Hippocampus_area
CGAGCACTTCAAGTTT	Hippocampus_area
CGAGCGTTGATCAGCC	Fiber_tracts
CGAGCTGGGCTTTAGG	Fiber_tracts
CGAGGCCAGGCATTGG	Isocortex_2
CGAGGCTAAATATGGC	CA3
CGAGGGACTGCGGTCG	Striatum
CGAGGGTATCCAGGTG	Cortical_subplate
CGAGTACTAAAGAGGA	Thalamus
CGAGTGAAGGTACCAG	Midbrain
CGAGTGCTATAGTTCG	Isocortex_2
CGAGTTCTGTCCCACC	Fiber_tracts
CGAGTTTATCGGACTG	Isocortex_2
CGATACCTCGCGGACA	Thalamus
CGATATTAGCCGCAGG	Isocortex_2
CGATCCGACCCAGTGC	Thalamus
CGATCCTCGCAACATA	Hypothalamus
CGATCTGTTGGAGGAC	Midbrain
CGATGGACCCTACGCC	Isocortex_2
CGATTAAATATCTCCT	Cortical_subplate
CGATTCGCCTGGCTGC	Olfactory_area
CGCAAACACGAGTTAC	Hippocampus_area
CGCAATTACTTTCGGT	Hippocampus_area
CGCAATTAGGGTAATA	Hippocampus_area
CGCAATTCTACAATAA	Hippocampus_area
CGCACATGTCCACTAC	Fiber_tracts
CGCACGTCTGTTTATG	Hypothalamus
CGCACGTGCGCTATCA	Isocortex_2
CGCAGAAACATTTGCG	Isocortex_2
CGCAGGCGATCCAAAC	Olfactory_area
CGCATCATGGCTTCAG	Isocortex_1
CGCATGGTGCGATGCT	Hippocampus_area
CGCATTAGCTAATAGG	Hippocampus_area
CGCCAAGAAGCCGAGT	Midbrain
CGCCACCCGCATTAAC	Isocortex_2
CGCCATCCGATTATGA	Fiber_tracts
CGCCCAGCACGCCTAG	Hippocampus_area
CGCCCGCTTCCGTACA	Isocortex_2
CGCCCTTGAAGGCTGA	Hippocampus_area
CGCCGCCCATGCCTGT	Striatum
CGCCTCCCTCCTCTAT	Hippocampus_area
CGCCTGGCCTACGTAA	Midbrain
CGCGACCGCGACAGAT	Olfactory_area
CGCGAGTCTGCCGGGT	Midbrain
CGCGCAAATGTCCAGA	Midbrain
CGCGCAAGGAACTACA	Isocortex_2
CGCGCATGTTTGATTG	Hippocampus_area
CGCGCCCGACTTAATA	Fiber_tracts
CGCGGCTCAACTTGAA	Isocortex_2
CGCGGGAATTAGGCAG	Hippocampus_area
CGCGTTCATGAAATAC	CA3
CGCTACGGGACATTTA	Thalamus
CGCTAGAGACCGCTGC	Isocortex_1
CGCTATACCGCCCACT	Hippocampus_area
CGCTATTCAATGTATG	Hippocampus_area
CGCTATTCTTAGGCTC	Midbrain
CGCTCGACATAATGAT	Hippocampus_area
CGCTCTCCGTAGATTA	Thalamus
CGCTGAGGACGTCCAA	Isocortex_1
CGCTGGTGACTACCCT	Olfactory_area
CGCTGTGACGCCGCAC	CA3
CGCTGTGTGGATGTTG	Hypothalamus
CGCTTAGTATTGATAC	Hippocampus_area
CGCTTATTCCCGGTCG	Midbrain
CGCTTCCACTGAAATC	Hippocampus_area
CGCTTTCATACCGGTG	Hippocampus_area
CGCTTTCTTGCATTCG	Fiber_tracts
CGGAAAGAATCAAACG	Hippocampus_area
CGGAACGTAAACATAG	Hippocampus_area
CGGAGCAATTTAATCG	Cortical_subplate
CGGAGCATGGCGATCC	Hippocampus_area
CGGAGCTTATAACACC	Isocortex_1
CGGAGTTTGAGAGACA	Thalamus
CGGATAAGCGGACATG	Hippocampus_area
CGGATCCTCAAGGACT	Olfactory_area
CGGATGAATGCTGTGA	Hypothalamus
CGGCAAACATCGTGCG	Cortical_subplate
CGGCACCGTTAGCGCC	Isocortex_1
CGGCACTCAAGAAAGT	Fiber_tracts
CGGCAGGGTCGGGTTG	Isocortex_2
CGGCCACGCACAAAGT	Midbrain
CGGCCCAGGTATATCC	Isocortex_1
CGGCGCCATCAATCCC	Olfactory_area
CGGCTTTGTATGATAA	Isocortex_2
CGGGAATATAGTATAC	Olfactory_area
CGGGAATTTATGTAAA	Hippocampus_area
CGGGAGCTTCAGTGTA	Olfactory_area
CGGGATCAATGTAAGA	Hippocampus_area
CGGGCAGCTAAACCGC	Thalamus
CGGGCCATAGCCGCAC	Isocortex_2
CGGGCCTTCTTTGTAA	Thalamus
CGGGTGTACCCATTTA	Fiber_tracts
CGGTACTAGAATCAAA	Striatum
CGGTAGAGGTGCAGGT	Isocortex_2
CGGTCAAGTGGGAACC	Fiber_tracts
CGGTCCGTCGCAAGCC	Cortical_subplate
CGGTCTATCAACCCGT	Isocortex_2
CGGTGAAGACTAAAGT	Midbrain
CGGTGCAGATAGAACG	Thalamus
CGGTGCGCGTTGGTCC	Thalamus
CGGTGTACTTGATCCC	Hippocampus_area
CGGTTATCCAACAGTG	Isocortex_2
CGGTTCAAGTAGGTGT	Isocortex_1
CGGTTCCGGCTTCTTG	Fiber_tracts
CGGTTGACCTGGCATA	Midbrain
CGGTTGAGTATCCTTC	Hypothalamus
CGTAAACGCTTGAGTG	Isocortex_2
CGTAAAGCAAGAAATC	Hypothalamus
CGTACCTGATAGGCCT	Hippocampus_area
CGTAGCGAATTGTCAG	Isocortex_2
CGTAGCGCCGACGTTG	Isocortex_2
CGTATTAAGAGATCTA	Thalamus
CGTCACGTCCATTGGT	Midbrain
CGTCAGTGCGCACAAG	Fiber_tracts
CGTCATACCATATCCA	Hippocampus_area
CGTCGCATGTGAGCCA	Olfactory_area
CGTCGCTTGGTTATAC	Hypothalamus
CGTCGGATAGTGTTGA	Isocortex_2
CGTCGGGTCTAAGCGC	Hypothalamus
CGTCGTCCTTCGCGAA	Olfactory_area
CGTCTGGAAGGGCCCG	Fiber_tracts
CGTGAAGTTAATTCAC	Thalamus
CGTGACATTGGGTCGT	Isocortex_2
CGTGACCAGTCCTCTG	Cortical_subplate
CGTGCAGACTGGGACA	Hippocampus_area
CGTGCATTGTCGACGC	Midbrain
CGTGCCCTCCCGAAGA	Striatum
CGTGCTGGCCTAGTCG	Isocortex_2
CGTGCTTCTACCTAAA	Hypothalamus
CGTGGCCGAATATCTA	Olfactory_area
CGTGGTACCCAAAGGC	Hypothalamus
CGTGTCCCATTCGCGA	Hippocampus_area
CGTGTCTCGTTACGAC	Hypothalamus
CGTTAATGTCCCGACG	Olfactory_area
CGTTAGCTCACAACTG	Isocortex_1
CGTTCAGACCCGCGAA	Olfactory_area
CGTTCATGGTGCGCGT	Midbrain
CGTTGAATACCGCGCT	Olfactory_area
CGTTGAGCGACCGTCG	Striatum
CGTTGCCCGCGTGGGA	Hippocampus_area
CGTTGTCGGCAATTGA	Olfactory_area
CGTTGTTTCAATTCCC	Thalamus
CGTTTAAGCGGAGCAC	Fiber_tracts
CGTTTCACTTCGGGCG	Isocortex_1
CGTTTCGCTCATTACA	Thalamus
CGTTTGTGTAGAGGGT	Hypothalamus
CTAAACGGGTGTAATC	Isocortex_1
CTAAAGAATGCCTACT	Thalamus
CTAAAGGGAAATAGGA	Hippocampus_area
CTAAAGTCCGAAGCTA	Isocortex_2
CTAAATCCGGTGTACA	Hypothalamus
CTAAATCCTATTCCGG	Isocortex_2
CTAACCGCGCGCCCGT	Thalamus
CTAACGAAACTTGCTG	Isocortex_2
CTAACTGGTCCGGTTC	Thalamus
CTAAGGGAATGATTGG	Hippocampus_area
CTAATTCGCACGCGCT	Hippocampus_area
CTAATTTCAACAACAC	Hippocampus_area
CTACAAGAAATAACCC	Hypothalamus
CTACACTAGCTTGTTC	Isocortex_1
CTACCCTAAGGTCATA	Isocortex_2
CTACGACTAGCTATAA	Midbrain
CTACGATCCTATCCTA	Hypothalamus
CTACGCACGGAGTACC	Thalamus
CTACGCCATTTCCGAT	Isocortex_1
CTACGTGTTGCCACCA	Isocortex_2
CTACTATCATAGGTTT	Midbrain
CTACTATCTTTCAGAG	Isocortex_2
CTACTCAAGGTATAGT	Hypothalamus
CTACTCTAGGCCCGGC	Midbrain
CTACTGCCACCTGACC	Hippocampus_area
CTAGATAAACTCCTCG	Isocortex_2
CTAGATGTGAGTGTAA	Isocortex_1
CTAGATTTACGACGGC	Hippocampus_area
CTAGCAACTAATTTAC	Isocortex_1
CTAGCATAGTATAATG	Hippocampus_area
CTAGCCGATGTTATGA	Isocortex_1
CTAGGCGCCCTATCAG	Fiber_tracts
CTAGGTCTGAAGGAAT	Isocortex_1
CTAGGTTCGGACGTGA	Olfactory_area
CTAGTAGAAAGGGATT	Olfactory_area
CTAGTATTCGGAATTA	Isocortex_2
CTAGTCACGTCTTAAG	Hippocampus_area
CTAGTGAAGGACAGGA	Thalamus
CTAGTTACAACCCGGT	Cortical_subplate
CTAGTTGGGCCCGGTA	CA3
CTATAAGAGCCAATCG	Isocortex_1
CTATAGGCGTTGATGT	Hypothalamus
CTATATCCAGCCTGGC	Hypothalamus
CTATCGACGAAATACA	Olfactory_area
CTATCGGGTCTCAACA	Hippocampus_area
CTATGAACACCTTGCC	Hypothalamus
CTATGCCCGAATGCAA	Cortical_subplate
CTATGTCACTAGCCCA	CA3
CTATGTCTATTGAAAC	Isocortex_2
CTATGTGAGTCACGGC	Midbrain
CTATTCATGTGTCCCA	Cortical_subplate
CTATTTGGTTACGGAT	Striatum
CTCAAACCACTGCCCG	Hypothalamus
CTCAACTAACCCGGAT	Hippocampus_area
CTCACATTTACTAAAT	Olfactory_area
CTCACTGTGATACTTA	Olfactory_area
CTCACTTGGCTGGTAA	Midbrain
CTCAGGACTCACCTGT	Hippocampus_area
CTCAGTCACGACAAAT	Isocortex_2
CTCATGGCTCACAATC	Isocortex_2
CTCATGGTAATTTGCG	Thalamus
CTCATTGCTCTAACAA	Olfactory_area
CTCATTTGATGGGCGG	CA1_CA2
CTCCCTCCTTTCGATC	Thalamus
CTCCGCCCACATGAGG	Thalamus
CTCCGGCCTAATATGC	Hippocampus_area
CTCCGGCTTGTAGACA	Isocortex_2
CTCCTAAGTTATGTCT	Fiber_tracts
CTCCTCCAGCTCACAC	Cortical_subplate
CTCGAGGCAAGTTTCA	Hypothalamus
CTCGAGGTCGAACAGT	CA3
CTCGATATTTGCGAGC	Isocortex_1
CTCGCACCTATATAGT	Hippocampus_area
CTCGCCGAATGTAGGG	Olfactory_area
CTCGGGTTCTCTGGCC	Hypothalamus
CTCGGTACCACTGCTC	Striatum
CTCGGTCCGTAGCCTG	CA1_CA2
CTCGGTTGTCGGCCCT	Midbrain
CTCGTCGAGGGCTCAT	Hypothalamus
CTCGTTACGGCTACCA	Hippocampus_area
CTCTACACTGGCGATT	Midbrain
CTCTATTTGGCTGCAG	Hippocampus_area
CTCTCACAATCGATGA	Hippocampus_area
CTCTCGATGTGCGCCT	Isocortex_1
CTCTCTAACTGCCTAG	Hypothalamus
CTCTGCAGGCATTCTT	Hypothalamus
CTCTGCGAAGCAAGCA	Fiber_tracts
CTCTGGACGCCTGGTG	Hippocampus_area
CTCTGTGCCTGCTATG	Hippocampus_area
CTCTGTTTGAGGATTC	Isocortex_2
CTCTTCTATTGACTGG	Olfactory_area
CTCTTCTGGAAGTTAG	Hypothalamus
CTCTTGTCCCGCTTGG	Cortical_subplate
CTGAAAGAGATCCGAC	Fiber_tracts
CTGAATCCGAGACCTC	Midbrain
CTGACTGCGCAGCTCG	Isocortex_1
CTGAGCAAGTAACAAG	Fiber_tracts
CTGATCCCTTTATGCA	Hypothalamus
CTGCACAACTACATAT	Olfactory_area
CTGCACCTGGAACCGC	Hippocampus_area
CTGCACTCCAGTACAG	Olfactory_area
CTGCCAAGGTTGGAAG	Fiber_tracts
CTGCCATGCATCACAT	Midbrain
CTGCCTAGCCACCAAG	Isocortex_1
CTGCCTTTAATACCTT	Hypothalamus
CTGCGGGTGAAATGTT	Midbrain
CTGCGGTAGTCACGTG	Hippocampus_area
CTGCGTTACGATATAA	Isocortex_1
CTGCTGAGGCCACGAA	Thalamus
CTGCTTGGCGATAGCT	Olfactory_area
CTGGAAATGGATGCTT	Thalamus
CTGGAAGACACGGTGG	Fiber_tracts
CTGGATTTACACTTGA	Hippocampus_area
CTGGCATCCGAATGAG	Thalamus
CTGGCGACATAAGTCC	Isocortex_2
CTGGCGCACAGGTCTG	Fiber_tracts
CTGGCGGGAATAAGTA	Hippocampus_area
CTGGCTCCTGCGGGAT	Isocortex_2
CTGGCTGATTCATCCT	Isocortex_2
CTGGCTGCTAACGTAA	Isocortex_2
CTGGCTGGTTGTCAGT	Hippocampus_area
CTGGGATAAATAATGG	Striatum
CTGGGCCTGCTATATC	Thalamus
CTGGGTAGGCAGTTAA	Striatum
CTGGTAACACATAGAA	Fiber_tracts
CTGGTAACGAGCTCTT	Isocortex_2
CTGGTCCTAACTTGGC	Isocortex_1
CTGGTGAATGGGCCTA	Hypothalamus
CTGGTTCAACGCATCA	Isocortex_2
CTGGTTTCGAGCAAGA	Fiber_tracts
CTGTACTTCTTAGCAT	Thalamus
CTGTAGCCATCTCACT	Hippocampus_area
CTGTATGGTGTAGAAA	CA1_CA2
CTGTCAAATGGCTCGG	Fiber_tracts
CTGTGCAGGGTAGGTC	Hippocampus_area
CTGTGGTCGGGAGATA	Olfactory_area
CTGTTACCCAATCTAG	Hippocampus_area
CTGTTCACTGCCTGTG	Hippocampus_area
CTGTTCATCTCACGGG	Hippocampus_area
CTGTTGTTCAGTCGTA	Hypothalamus
CTTAACTTCGAAGTAC	Isocortex_2
CTTACACGGTATTCCA	Thalamus
CTTACACTGGGAAATA	Hippocampus_area
CTTAGCCTTCCACATG	Fiber_tracts
CTTAGGTATAGACCAG	Hypothalamus
CTTAGTAGGCCTACAG	Isocortex_1
CTTAGTGTAGTAGCAT	Olfactory_area
CTTAGTTGAGGAATCG	Hypothalamus
CTTATGTTGACTACCA	Fiber_tracts
CTTCAACTCCACTTGG	Olfactory_area
CTTCACGCCCTGGTAC	Hypothalamus
CTTCAGTGGTCGCCTA	Midbrain
CTTCATAGCTCAAGAA	Hippocampus_area
CTTCATTGTCAGTGGA	Midbrain
CTTCCGCTCCGTGAAG	Hippocampus_area
CTTCGTAGATAGGTGA	Thalamus
CTTCTATGTTGAAGTA	Midbrain
CTTCTATTAATGCTAG	Midbrain
CTTCTGGGCGTACCTA	Hypothalamus
CTTCTTACGTCGTATA	Fiber_tracts
CTTGACCCGAAAGATA	Isocortex_2
CTTGAGGTTATCCCGA	Isocortex_2
CTTGAGTTAGGGTAAT	Fiber_tracts
CTTGCAACCGCCTCCT	Midbrain
CTTGCCCAGGCTCTAC	Midbrain
CTTGGCCAAGCTGGGA	Cortical_subplate
CTTGTACTTGTTGACT	Hippocampus_area
CTTGTCAACATTCGAG	Cortical_subplate
CTTGTGAGTCTTTGAC	Fiber_tracts
CTTGTGCTCACCGATT	Isocortex_2
CTTGTTGCTGAGTCAA	Striatum
CTTGTTTATGTAGCCA	Hippocampus_area
CTTTAACTTTCAAAGG	CA1_CA2
CTTTAATATTGGTCGA	Olfactory_area
CTTTACCGAATAGTAG	Olfactory_area
CTTTAGGAACACTGTT	Fiber_tracts
CTTTAGTGCTATTATT	Hippocampus_area
CTTTCTGTGCGGGCTT	Cortical_subplate
CTTTGGCGCTTTATAC	Midbrain
CTTTGGCTTTAGTAAA	Thalamus
CTTTGGGATTGTTGCA	Hypothalamus
GAAACAGATGACCACC	Isocortex_2
GAAACAGCCATGCAGT	Fiber_tracts
GAAACATAGGAAACAG	Hypothalamus
GAAACCGAATTACCTT	Thalamus
GAAACCTATACAAATG	Cortical_subplate
GAAACTCGTGCGATGC	Hippocampus_area
GAAACTCTAATGAAGG	Isocortex_2
GAAAGAACAGCGTTAT	Isocortex_1
GAAAGCAGTGCACTTT	Hippocampus_area
GAAAGCCCTTTGGACC	Midbrain
GAAAGTGACTAACTGC	Hippocampus_area
GAAATACTAAACGTTT	Hippocampus_area
GAAATATCACCATCAG	Midbrain
GAAATCGCGCGCAACT	Fiber_tracts
GAAATGGCGGTGTTAG	Thalamus
GAAATGGGATGTAAAC	Isocortex_2
GAAATTAGCACGGATA	Isocortex_1
GAAATTCACATCGCTG	Fiber_tracts
GAAATTGTCTCTATAA	Thalamus
GAACACACATCAACCA	Hippocampus_area
GAACAGATTACTAAAT	Olfactory_area
GAACCATCTGGGAGAC	Isocortex_1
GAACCCTCTGTGTTCT	Olfactory_area
GAACCTTTAACGATCC	Olfactory_area
GAACGACCGAATGATA	Hippocampus_area
GAACGTCTCATGGTCG	Fiber_tracts
GAAGAAACGATATTGT	Hypothalamus
GAAGAACGGTGCAGGT	Hippocampus_area
GAAGCCACTGATTATG	Olfactory_area
GAAGCCTGCACATTCC	Cortical_subplate
GAAGCGTGAGGAATTT	Thalamus
GAAGCTCGGACCCGTC	Hypothalamus
GAAGCTTGCTGACCGC	Thalamus
GAAGGAGTCGAGTGCG	Olfactory_area
GAAGTCAGTTGCACTA	Hippocampus_area
GAAGTCTCCCTAGCGA	Fiber_tracts
GAAGTGATTTATCGTG	Thalamus
GAAGTGCTGGATAGCT	Fiber_tracts
GAAGTTTCCACTCAAT	Thalamus
GAATAGACGCGACCCA	Isocortex_2
GAATAGTGCTCGATTA	Hypothalamus
GAATATTCGGAGTCCC	Isocortex_2
GAATCGACATGGTCAC	Hippocampus_area
GAATCGCCGGACACGG	Fiber_tracts
GAATCTGAACATTCTC	Hippocampus_area
GAATGCCGAAATGACC	Hippocampus_area
GAATGCGAATCGGTTC	Olfactory_area
GAATGTATGGCAGGTC	Isocortex_1
GAATGTGGTCCGGATT	Striatum
GAATGTTGGGTAATCT	Hippocampus_area
GAATTATAGTGAAAGG	Hippocampus_area
GAATTCACCCGGGTGT	Hippocampus_area
GAATTTCTCGCTGCAG	Hippocampus_area
GACAAACATATGCAGG	Isocortex_2
GACAACGACCATTGAA	Hippocampus_area
GACAACGCAGCTTACG	Hippocampus_area
GACACAAGGGAAGAAA	Hippocampus_area
GACACGAGTTAGAGGA	Hippocampus_area
GACACTGAGTTCAGTG	Thalamus
GACAGCCAGACCTGAC	Olfactory_area
GACAGGCACACACTAT	Hippocampus_area
GACATCCGTCGAACTG	Olfactory_area
GACATCGATTTATAAC	Hippocampus_area
GACCAGAGCCCTGTAG	Thalamus
GACCCAATTATGATAC	Midbrain
GACCCGTCGCCGGCTA	Isocortex_2
GACCGACTGAAGCGTC	Midbrain
GACCGATTAAATATGT	Hypothalamus
GACCGTCAGGTCGTGA	Isocortex_2
GACCGTGCTGACGGTG	Thalamus
GACCTTCCACGTCTAC	Olfactory_area
GACGACGATCCGCGTT	Olfactory_area
GACGCCGTAAAGGCTA	Hippocampus_area
GACGCCTGTTGCAGGG	Fiber_tracts
GACGCTTGCTTCTAAA	Thalamus
GACGGACCGCGTTCCT	Isocortex_1
GACGGGTTGGCCCGTA	Cortical_subplate
GACGGTCAATAGAAGC	Isocortex_1
GACGTGAGACTCCATG	Isocortex_2
GACGTGTAGGGATTAT	Hippocampus_area
GACTAAGATCATGCAC	Hippocampus_area
GACTAAGTAGGCTCAC	Hippocampus_area
GACTACAAAGCGGTGG	Thalamus
GACTACAATTGCTCGT	Isocortex_1
GACTCACCCACGTGAG	Olfactory_area
GACTCGCGGGAATGAC	Isocortex_2
GACTGCAAATCGAGCT	Olfactory_area
GACTGCACCAGCCCAG	Olfactory_area
GACTGCTGGTGAGAAA	Hypothalamus
GAGACTGATGGGTAGA	CA3
GAGACTTCGCGACCGA	Hippocampus_area
GAGAGGGCGCGAGGTT	Thalamus
GAGAGGTGCATTCTGG	Midbrain
GAGATCTGCTTGGCAT	Thalamus
GAGATCTGTCACTCCG	Hippocampus_area
GAGATCTTCCATGACA	Striatum
GAGATGGGAGTCGACA	Olfactory_area
GAGCACCTGTGTCCAG	Olfactory_area
GAGCATCAACAACTTG	Hypothalamus
GAGCATCATCCCTGGG	Fiber_tracts
GAGCCACGGTAGTAGG	Isocortex_2
GAGCCAGCTACCTGTG	Olfactory_area
GAGCGAGGGAGTACCG	Fiber_tracts
GAGCGCGCACGAGTAG	Olfactory_area
GAGCGCTGTTAGGTAA	Hypothalamus
GAGCTAAGGGCATATC	Fiber_tracts
GAGCTCTCGGACCTAA	Hippocampus_area
GAGGAATGGAGAGGTT	Hippocampus_area
GAGGCCCGACTCCGCA	Hypothalamus
GAGGCTATCAAAGTCG	Midbrain
GAGGGAGTCAGATCGC	Hypothalamus
GAGGGCATCGCGTATC	Fiber_tracts
GAGGGCGCAGCTCTGC	Isocortex_2
GAGGGTAGTAACAAAG	Hypothalamus
GAGGTACATCCATCTT	Isocortex_2
GAGGTACGCGTGTCCC	Olfactory_area
GAGGTCCCAAAGATCT	Hippocampus_area
GAGTACGGGTATACAA	Hippocampus_area
GAGTAGATACTAGTTG	Olfactory_area
GAGTATACCCTAATCA	Hypothalamus
GAGTATGCCCGCCTTG	Midbrain
GAGTATGCGCGTGCAT	Olfactory_area
GAGTCAGACCAGAATC	Hippocampus_area
GAGTCCGCTTACCGGA	Hippocampus_area
GAGTGTCAACCAGAAA	Olfactory_area
GAGTGTGCGGTACCCA	Fiber_tracts
GAGTTGATGGCAATTT	Midbrain
GATAAATCGGTGGATG	Hippocampus_area
GATAACTCGCACTGTG	Fiber_tracts
GATAAGGCAGATGCAA	Fiber_tracts
GATACGATGGGAGTCA	Thalamus
GATAGGTAACGTTGAC	Hippocampus_area
GATATCTCATGCAATA	Isocortex_2
GATATGAGACACTAAC	Striatum
GATATGCGGTAGCCAA	Isocortex_2
GATATGGATTACGCGG	Hippocampus_area
GATATTGAGATTGGCG	Isocortex_1
GATATTTCCTACATGG	Isocortex_2
GATCAACATAAAGGGA	Hypothalamus
GATCATTCCAAACATT	Thalamus
GATCCCTTTATACTGC	Hippocampus_area
GATCCGGGAATTAACA	Hippocampus_area
GATCCTAAATCGGGAC	Isocortex_2
GATCCTCGACACTGGC	Thalamus
GATCGACACTATCTGA	Hippocampus_area
GATCGCGGGCTCTCCA	Thalamus
GATCGCTACCCGATTT	Olfactory_area
GATCGCTATATCTCAG	Hypothalamus
GATCGCTGTGGTGCGT	Hypothalamus
GATCGGTGGCCATAAC	CA3
GATCGTGACTGATATC	Hippocampus_area
GATCTGCTATCTAAGG	Cortical_subplate
GATCTTGGAGGGCATA	Hippocampus_area
GATCTTTGCAGGGTAT	Thalamus
GATGACAAGTAGGGCA	Hypothalamus
GATGCCAGCAGAAGGC	Hippocampus_area
GATGCGTCCTGCATTC	Midbrain
GATGCTACAAGCGCCT	CA1_CA2
GATGCTGTATTTCATC	Striatum
GATGGCGCACACATTA	Hippocampus_area
GATGGTGCCCTAGGCA	Isocortex_1
GATGTAACGAACCACC	Midbrain
GATGTCCGGATCACAT	Isocortex_2
GATGTCGGTCAACTGC	Isocortex_1
GATGTTCAATCCACGA	Thalamus
GATGTTTGTGCGAGAT	CA1_CA2
GATTAACCGAAAGCCC	Olfactory_area
GATTACTGAATTTGGG	Thalamus
GATTCCCTTGTCGCAG	CA3
GATTCCGCGTTTCCGT	Isocortex_2
GATTCCTATACGGCGC	Hippocampus_area
GATTCGACGGTTCACG	Hippocampus_area
GATTGACACTCTGCTC	Isocortex_1
GATTGCTCCAGTTGCA	Hypothalamus
GCAAACCCTACATTAT	Olfactory_area
GCAAACCTTGGCCATA	Olfactory_area
GCAAAGGGCGTTAGCC	Hypothalamus
GCAAATATTACGCTTT	Thalamus
GCAACACACTAGAACT	Midbrain
GCAACAGCAGTATGCG	Hippocampus_area
GCAACCACCAGACCGG	Isocortex_1
GCAACCACGGCCGCGT	Midbrain
GCAAGAATTCCTTGGC	Thalamus
GCAAGTGCACAGAGAA	DG
GCACAAACCCTAGATG	Hypothalamus
GCACAAGTGTCGGAAG	Isocortex_2
GCACACACTGGTAGCC	Olfactory_area
GCACGCCTACTTAGAT	Hypothalamus
GCACTAGTCGCGCTAT	Fiber_tracts
GCACTGCCTACCTTTA	Olfactory_area
GCACTGTGCAAATGTA	Isocortex_2
GCAGACCCAGCACGTA	Isocortex_1
GCAGATCCATAAGACT	Olfactory_area
GCAGATTAGGGATATC	Midbrain
GCAGCACACAGCCCAG	Thalamus
GCAGCGGTGGGCATTA	Isocortex_2
GCAGGAACTTAGATCT	Midbrain
GCAGGACTATAGAATA	Thalamus
GCAGGTAGAGTATGGT	Isocortex_1
GCAGTGTGGCTATAGG	Olfactory_area
GCATAGAGCACTCAGG	Midbrain
GCATCCCTAACTTTGA	CA1_CA2
GCATCGGCCGTGTAGG	Olfactory_area
GCATGAGGGACGCGGC	Isocortex_2
GCATTGTAATTCATAT	Midbrain
GCCACAATTTAAGGAC	Thalamus
GCCACTCAGAGCGCGA	Olfactory_area
GCCAGGAAAGAACACT	Hippocampus_area
GCCAGGAGTAACCGAT	Isocortex_2
GCCAGGCGTTCGCATG	Hippocampus_area
GCCATATTGCACACAG	Isocortex_2
GCCATCGAGCTGCGTG	Midbrain
GCCCACCAAGGCTGTC	Isocortex_2
GCCCAGTTGGTATGCC	Hippocampus_area
GCCCGACTTCTTCCCG	Thalamus
GCCCGATCTGTGGTCG	Cortical_subplate
GCCCGCGCGTAAACGG	Midbrain
GCCCGCGCGTTTGACA	Hippocampus_area
GCCCGTAATACCTTCT	Hippocampus_area
GCCCTAGCCGTCGCGA	Midbrain
GCCGAAATTCCTACGT	Thalamus
GCCGACCCACGACTGC	Hypothalamus
GCCGATTGGCCAAGCT	Midbrain
GCCGCATTAGTCCGGC	Midbrain
GCCGCTTGTGAGAAAC	Thalamus
GCCGGAAACACATCTT	Isocortex_1
GCCGGGTTAGGGTCGC	Midbrain
GCCTAGCGATCTGACC	Hippocampus_area
GCCTATAGTGTCAGGG	Isocortex_2
GCCTATTCCGATATAG	Hippocampus_area
GCCTATTTGCTACACA	Isocortex_2
GCCTCATCTGGAAATA	Isocortex_2
GCCTCTATACATAGCA	Olfactory_area
GCCTTCAGCCCTACCG	Hippocampus_area
GCCTTGTATATGCAGT	Hippocampus_area
GCGAAACGATCGGGAG	Olfactory_area
GCGAAACTTAACTGGA	Olfactory_area
GCGAAGCCATACCCGT	CA3
GCGACCCAACCATCTG	Hypothalamus
GCGACGATAGTTGTAC	Midbrain
GCGAGAGTTGCGTCCA	Hippocampus_area
GCGAGGCCCGAGCAGA	Thalamus
GCGAGTTCTGCAAAGA	Hippocampus_area
GCGATTCTGGAAGCAG	Isocortex_1
GCGATTGTTAACGTTA	Hippocampus_area
GCGCAAATATATTCAA	Hypothalamus
GCGCAAGAGCGCGCTG	Isocortex_2
GCGCATCCAGTCAGCA	Isocortex_2
GCGCCGTTCCACGATA	Hippocampus_area
GCGCGATGGGTCAAGT	Hippocampus_area
GCGCGGTCTAGTAACT	Hippocampus_area
GCGCGTCATTGGTACA	Olfactory_area
GCGCTAATTGAATAGA	Hippocampus_area
GCGCTATGCCGAGGCA	Thalamus
GCGCTGATCCAGACTC	Isocortex_2
GCGCTGCTTTGCATTT	Isocortex_2
GCGCTTAAATAATTGG	Olfactory_area
GCGGACCGCGTTGTGG	Midbrain
GCGGAGAAACTTCGCA	Midbrain
GCGGAGAGGGAGAACG	Striatum
GCGGCAAAGTATTGCC	Hypothalamus
GCGGCTCTGACGTACC	Thalamus
GCGGGAACCAGGCCCT	Hippocampus_area
GCGGGCGAGCCTTACC	Hippocampus_area
GCGGTAACCCAAATGA	Isocortex_2
GCGGTCCCTAGACGCA	Fiber_tracts
GCGGTGAACTGCGCTC	Isocortex_1
GCGGTTCCCTATCATG	Midbrain
GCGTAAATGGCCATAA	Isocortex_1
GCGTCCCTAAGACATA	Cortical_subplate
GCGTCGAAATGTCGGT	Fiber_tracts
GCGTCGCCAGGGTGAT	Cortical_subplate
GCGTCTCTGCATTGGG	Thalamus
GCGTGGTACTGGGTTA	Isocortex_2
GCTAAACCTGAGGTGA	Hippocampus_area
GCTAACTGAAGTCTGA	Olfactory_area
GCTAAGTAGTTTCTCT	Striatum
GCTAATACCGAATGCC	Hippocampus_area
GCTACGACTTATTGGG	Hippocampus_area
GCTACTATAGTAGAGT	Olfactory_area
GCTAGACCGTCTACTG	Isocortex_1
GCTAGAGTAGAGATGT	Olfactory_area
GCTAGCGATAGGTCTT	Hypothalamus
GCTAGCTTGAATAGCT	Midbrain
GCTAGGCACCACGGAG	Olfactory_area
GCTAGTAGAGCTTGTA	Hippocampus_area
GCTAGTTTCATTGAGG	CA1_CA2
GCTATACGTCTCGGAC	Fiber_tracts
GCTATCATACTCATGG	Olfactory_area
GCTATCGCGGCGCAAC	Hippocampus_area
GCTCAATCCGTTTATT	Midbrain
GCTCAATGTAATACCG	Cortical_subplate
GCTCATTACTGCATGT	Isocortex_1
GCTCCTGACATACTGG	Midbrain
GCTCGCTCATGTCCAA	Isocortex_2
GCTCGGAATTTAAAGC	Fiber_tracts
GCTCTAAACCCTGACG	Hippocampus_area
GCTCTATGTTACGTGC	Hippocampus_area
GCTCTCGGGTACCGAA	Hippocampus_area
GCTCTTTCCGCTAGTG	Cortical_subplate
GCTGAATCTTCCAATC	Hypothalamus
GCTGAGGCGTGAGTAT	Hippocampus_area
GCTGCACGGTTTCTTA	Hippocampus_area
GCTGCTAAGTAGTCGA	Cortical_subplate
GCTGCTACTGCGTAGC	Olfactory_area
GCTGCTCTCCGGACAC	CA3
GCTGGCATATTCACCT	Thalamus
GCTGGCGGCGCATGCT	Cortical_subplate
GCTGGGTCCGCTGTTA	Isocortex_2
GCTGGTTTAGGCCATA	Midbrain
GCTGTATTACTGGCCC	Thalamus
GCTGTTGCTACCGAAC	Fiber_tracts
GCTTAATGTAACTAAC	Striatum
GCTTATGAAGCAGGAA	Fiber_tracts
GCTTCCGTCCCTAGAC	Hippocampus_area
GCTTCGACGTTCAATC	Hypothalamus
GCTTGATGATAATCAG	Hippocampus_area
GCTTGGATCGATTAGG	Isocortex_2
GCTTTCAGAGGAGGTG	Isocortex_2
GGAAAGTGCCCATGCC	Isocortex_2
GGAACCGTGTAAATTG	Midbrain
GGAACCTTGACTCTGC	Hypothalamus
GGAAGCTCGCTTACAG	Isocortex_1
GGAATAACCTCAAGAA	Isocortex_1
GGAATGCGCTAGCGTG	Hippocampus_area
GGACCAACAGGATAAC	Cortical_subplate
GGACCTCTAGGCCGCC	Hypothalamus
GGACTCGTGAGTGGTC	Hypothalamus
GGAGAAGTCATTGGCA	Hippocampus_area
GGAGACGACACCTTTG	Hippocampus_area
GGAGCACCAAGAACTA	Fiber_tracts
GGAGCGAGGCCTACTT	Hippocampus_area
GGAGGATTGAAAGGAG	Isocortex_1
GGAGGGCTTGGTTGGC	Striatum
GGAGTGCCGCCCTGGA	Hippocampus_area
GGATACTCATGAATTG	Isocortex_2
GGATCAAAGGACGAGG	Isocortex_1
GGATCCGGAATATACT	Striatum
GGATCTTACTGCCCTT	Hypothalamus
GGATCTTGACTCAACC	Midbrain
GGATGAAGATCGCTGA	Isocortex_2
GGATGACGCGAGTTTA	Thalamus
GGATGCTGGCGTTCCT	Midbrain
GGATGTCCTTACCGCA	Fiber_tracts
GGATTCAGTACGGTGG	CA1_CA2
GGATTCCGCTATACCC	Isocortex_2
GGATTGCTGTGACTCC	Olfactory_area
GGATTTCACTTCTATA	Fiber_tracts
GGCAAAGGCGCCAATA	Midbrain
GGCAAATTACTTTACT	Thalamus
GGCAAGCCCATAGTGG	Olfactory_area
GGCAAGGCGAAATAGC	Hippocampus_area
GGCAATAGTCAATGAG	CA3
GGCACTCCACTGGGCA	Thalamus
GGCAGCAAACCTATGC	Olfactory_area
GGCATACAGGTAGCGG	Thalamus
GGCATATCGGTTCTGC	Isocortex_2
GGCATCAACGAGCACG	Isocortex_1
GGCCACAAGCGATGGC	Isocortex_1
GGCCCTCACCCACTTA	Midbrain
GGCCGAGACTCTGGTG	Hypothalamus
GGCCGGCGTCTGCTAT	Olfactory_area
GGCCGTTTGGGTTTCA	Hypothalamus
GGCGAAATCTAACTTG	Fiber_tracts
GGCGCAGGACATCTTC	Midbrain
GGCGCATGAATTGATG	Thalamus
GGCGCGGAGATCTTTC	Olfactory_area
GGCGCGTTCGAGTTTA	Hippocampus_area
GGCGCTCCTCATCAAT	Isocortex_2
GGCGGAGTAATATTAG	Thalamus
GGCGGTAGGATCATTG	CA3
GGCGTCCTATCCGCTG	Thalamus
GGCTAAAGGGCGGGTC	Isocortex_1
GGCTACTATACACTCC	Hypothalamus
GGCTATTAAGTTGTAT	Thalamus
GGCTCCTCCACCTGTT	Hypothalamus
GGCTCGCGTTGAGGTA	Isocortex_2
GGCTCGTGCCACCAGC	Hippocampus_area
GGCTCTGCTCCAACGC	Hippocampus_area
GGCTGAAATAGCAAAG	Olfactory_area
GGCTGGCTAGCTTAAA	Fiber_tracts
GGCTTTCAATAAGGGT	Cortical_subplate
GGGAACGGGAGGTTAG	Thalamus
GGGAACGGTTTCAGAT	Hypothalamus
GGGAAGACGGTCTGTC	Olfactory_area
GGGACAGAGTTACTCC	Hypothalamus
GGGACCCGTATATCTT	Hippocampus_area
GGGACTGCATAGATAG	Hippocampus_area
GGGAGAACTCACAGTA	CA3
GGGAGGATGCCCGAAA	Thalamus
GGGAGTAATGGCTGGC	Isocortex_2
GGGAGTTAATGAGGCG	Hippocampus_area
GGGATGGTCGTAACCG	Hippocampus_area
GGGATTTACCGCACCT	Fiber_tracts
GGGCAACCGCACGTGC	Midbrain
GGGCAGAGCAATCGTT	Cortical_subplate
GGGCCCGTCTTAAACA	Thalamus
GGGCCCTACGAAAGGG	Midbrain
GGGCCGGCCGAAGTAC	Striatum
GGGCGATATGTGTGAA	CA3
GGGCGGCAAATGAATT	Midbrain
GGGCGGGTTCCCTACG	Thalamus
GGGCGGTCCTATTGTC	Hippocampus_area
GGGCGTACATTTATAT	Hippocampus_area
GGGCGTCACCACGTAA	Midbrain
GGGCGTCCACTGGCTC	Isocortex_2
GGGCGTGGTTTCCCAG	Olfactory_area
GGGCGTTTACATTCAT	Hypothalamus
GGGCTATGATCGATGG	Hippocampus_area
GGGCTCATCGAACCCA	Isocortex_2
GGGCTGCCTAGGGCGA	Hippocampus_area
GGGCTGGTTAGTCGCG	Thalamus
GGGTAATGCTGTGTTT	Isocortex_2
GGGTACCCACGGTCCT	Fiber_tracts
GGGTACTTCATGAACT	Thalamus
GGGTATGTATGCACTT	Hippocampus_area
GGGTATTCTAGCAAAC	Hypothalamus
GGGTCACCGTGACGGT	Thalamus
GGGTCAGGAGCTAGAT	Cortical_subplate
GGGTCCTTGGAAGAAG	Hypothalamus
GGGTGACACCTTAACT	Hippocampus_area
GGGTGGTCCAGCCTGT	Isocortex_1
GGGTGTTTCAGCTATG	Fiber_tracts
GGGTTAACATTTGAGT	Hippocampus_area
GGGTTCAGACGAACAA	Hippocampus_area
GGTAAATGTGCGTTAC	Isocortex_1
GGTAACCGGGAGGATA	Midbrain
GGTAACTATGTATCTG	Fiber_tracts
GGTACAAACATGCTAT	Thalamus
GGTACATCTGGGACGA	Midbrain
GGTACCATTAAGACGG	Isocortex_1
GGTAGAAGACCGCCTG	Olfactory_area
GGTAGACCGTTGGGCG	Hippocampus_area
GGTAGTGCTCGCACCA	Hippocampus_area
GGTATTGCCGAGTTTA	Thalamus
GGTCACGTTAGATTCA	Isocortex_1
GGTCAGTGGGTCCCAC	Hippocampus_area
GGTCGGATAAACGGCG	Isocortex_1
GGTCGGCCAGGAGCTT	Fiber_tracts
GGTCGGTAATTAGACA	Fiber_tracts
GGTCGGTCGTCCACAG	Hippocampus_area
GGTCGTAAGCTCGCAC	Midbrain
GGTCTCTGAATGGACT	Midbrain
GGTCTGAGAATCTGGA	Hippocampus_area
GGTCTTGAGCGCTCTT	Olfactory_area
GGTGAAACCGGGAATG	Isocortex_1
GGTGAACGGGCTAGCC	Isocortex_2
GGTGAAGTACAGGGAT	Thalamus
GGTGAGATGCAGATAA	CA1_CA2
GGTGATAAGGAGCAGT	Striatum
GGTGATTTCATCTTGT	Isocortex_2
GGTGCGGATAAGTGGC	CA1_CA2
GGTGCTGATCACAAAG	Hippocampus_area
GGTGCTGGTACACATT	Thalamus
GGTGGACTGCTCTGGC	Hippocampus_area
GGTTACCACCCTCGGG	Thalamus
GGTTAGCTATATGTCT	Olfactory_area
GGTTAGGCTTGGAGAA	Hippocampus_area
GGTTAGTTACGGCGCC	Hippocampus_area
GGTTCTACTCGTCTGA	Olfactory_area
GGTTTAATTACCATCG	Hypothalamus
GGTTTACAATCTCAAT	Hippocampus_area
GGTTTAGCCTTTCTTG	Olfactory_area
GGTTTCAATCGGTCAG	Fiber_tracts
GGTTTGAGTGCTGGAA	Fiber_tracts
GTAACTTGCGGCAGTC	Isocortex_2
GTAAGCGGGCAGTCAG	Hippocampus_area
GTAAGGATTTGTCGGA	Isocortex_2
GTAAGTAACAGTCTGG	Striatum
GTAAGTAGGGTATACC	Hippocampus_area
GTAATAAAGGGCTCCC	Isocortex_1
GTAATCTGATTCTTCG	Midbrain
GTACACTTACCTGAAG	Hippocampus_area
GTACAGAGGCAAGGGT	Striatum
GTACGACGGCGCTGCG	Fiber_tracts
GTACGAGATTGCGACA	Hippocampus_area
GTACGCTTCATTGCAC	Cortical_subplate
GTACGTTTGCCCGTCA	Hippocampus_area
GTACTAAGATTTGGAG	CA3
GTACTCCCTTATCGCT	Midbrain
GTACTCCTGGGTATGC	Isocortex_1
GTACTGAGGTCGTAAC	Fiber_tracts
GTACTGCATGAAGCGT	Fiber_tracts
GTACTGGAGTTAGACC	Striatum
GTACTTGGGCACTTCT	Hippocampus_area
GTAGACAACCGATGAA	Isocortex_2
GTAGACACGCCTGACT	Olfactory_area
GTAGACGTCGTTACAT	Fiber_tracts
GTAGAGGGAGACAAGT	Midbrain
GTAGCCAAACATGGGA	Cortical_subplate
GTAGCGCTGTTGTAGT	Isocortex_1
GTAGCGGCTATACACT	Hippocampus_area
GTAGCTCCGGGAGGCT	Hypothalamus
GTAGCTTCCTCTTGTT	Fiber_tracts
GTAGGTGATCCGTGTA	Isocortex_2
GTAGTCGCGGGAATCA	Olfactory_area
GTAGTCTACGATATTG	Olfactory_area
GTAGTTCGAAGGCGAA	Hypothalamus
GTATAGGACTCAGTAG	CA1_CA2
GTATATGTTACGGCGG	Isocortex_2
GTATCAAACGTTAGCT	Olfactory_area
GTATCAGCTTGGGTTC	Hippocampus_area
GTATCTCAGTCTTGAC	Midbrain
GTATCTTTCATAACCA	Hippocampus_area
GTATGAAATTTCACTC	Midbrain
GTATGACGTGGGAAAC	Isocortex_2
GTATGTGGGTCTAGTT	Fiber_tracts
GTATTAAGGCGTCTAA	Hippocampus_area
GTATTCTGAGAAACGA	Thalamus
GTATTCTTACCGTGCT	Isocortex_2
GTCAAAGAAGTGGTGT	Midbrain
GTCAAAGTTTACATAG	Hippocampus_area
GTCAAGCGGACTCGGG	Striatum
GTCAATTGTACTGAAG	Isocortex_1
GTCACAAAGTTTCCAA	Isocortex_2
GTCACTCTCCAAATCT	Hippocampus_area
GTCAGAATAGTCTATG	Midbrain
GTCAGTTGTGCTCGTT	Isocortex_1
GTCATGCACCTCCGTT	Hippocampus_area
GTCATGGACATGACTA	Hippocampus_area
GTCATTAGAGCGAACG	Hippocampus_area
GTCCAATATTTAGCCT	Cortical_subplate
GTCCATTACTGCTACG	Olfactory_area
GTCCCAACGTAAAGTA	Hippocampus_area
GTCCCGCGACGTTATG	Olfactory_area
GTCCGGACCTGAAATT	Olfactory_area
GTCCGGCTGAATTGCG	CA3
GTCCTACAGGCGGCTC	Hippocampus_area
GTCCTACGAATAGTCT	Olfactory_area
GTCCTTCTAGTGGGTT	Isocortex_1
GTCGAATTTGGGCGCT	Hypothalamus
GTCGCCGTTGTGTGTT	Hypothalamus
GTCGCGTAACCCGTTG	Hippocampus_area
GTCGGATATCTCAGAC	Thalamus
GTCGGATGTAGCGCGC	Isocortex_2
GTCGGGAAGCAGAAAC	Olfactory_area
GTCGTACCATCTCGGG	Hippocampus_area
GTCGTATTGGCGTACA	Isocortex_1
GTCGTCAATTATAAGG	Isocortex_2
GTCGTTATTCGCTTAT	Striatum
GTCTATCTGAGTTTCT	Thalamus
GTCTATTGGTTCCGGT	Fiber_tracts
GTCTCAAGGCCCGGCT	Olfactory_area
GTCTCGATCTGCTTTC	Fiber_tracts
GTCTGGGCGGTCGAGA	Thalamus
GTCTTAGTACAGCCGG	Isocortex_2
GTGAAACGGCGCCACC	Isocortex_2
GTGAAACGTGCTCCAC	Fiber_tracts
GTGAACTCCCATTCGA	Olfactory_area
GTGACAGCTTCCCACT	Olfactory_area
GTGACCGCACACTACG	Fiber_tracts
GTGACGCAGGTTTCAT	Olfactory_area
GTGACTTCAGTAGTGC	Midbrain
GTGAGCGTGCTGCACT	Midbrain
GTGAGGACACTTAAGG	Striatum
GTGAGGAGCGGTTGAG	Isocortex_1
GTGAGTGGTACAACGC	Hippocampus_area
GTGATCAAGCGTGCAC	Hypothalamus
GTGATCACTAACGCCT	Isocortex_2
GTGATCATAGATCTGC	Hippocampus_area
GTGATCCTTGTCATGA	Olfactory_area
GTGATTCGCCGCTCAA	Thalamus
GTGCAACAAATGTGGC	Fiber_tracts
GTGCACCAGCTTCAAC	Cortical_subplate
GTGCACGAAAGTGACT	Fiber_tracts
GTGCCATCACACGGTG	Thalamus
GTGCCCGTTCGGATTC	Striatum
GTGCCGCTTCAAAGGT	Thalamus
GTGCCTCAGTGTACGG	Isocortex_1
GTGCGAAATCGAACAC	Thalamus
GTGCGACAGGGAGTGT	Isocortex_1
GTGCGCAGCTTGCTCC	Isocortex_2
GTGCGGGACCATCGGC	Isocortex_1
GTGCGGGTCTCCAAAT	Hippocampus_area
GTGCGTGTATATGAGC	Striatum
GTGCTCAAGTACTGTC	Thalamus
GTGGAACCTACATGCG	Isocortex_2
GTGGACCAACCCGATT	Midbrain
GTGGACGCATTTGTCC	Cortical_subplate
GTGGACGTGCTGAGAC	Hippocampus_area
GTGGAGCGTTTACCGA	Midbrain
GTGGAGTCGGCGGTTG	Midbrain
GTGGCAAACAGCGGCA	Midbrain
GTGGCGGTCCCAGCGT	Midbrain
GTGGGAAGACTGAATC	Midbrain
GTGGGCTTAGACACAC	Thalamus
GTGGTATAGTCTGCCG	Hypothalamus
GTGGTGGCCAAGTGAA	Striatum
GTGGTTACTTCTTTCG	Olfactory_area
GTGGTTTCCGCCTTTC	Thalamus
GTGTACCTTGGCTACG	Hippocampus_area
GTGTATATCAGCGGGC	Olfactory_area
GTGTATGACTTTAAAG	Isocortex_1
GTGTCGTATAGCGTTC	Olfactory_area
GTGTGAATAACTTAGG	Fiber_tracts
GTGTGAGCCGAGGTGC	Isocortex_1
GTGTTACTATGCGTCC	Striatum
GTTAAAGTAGGACTGG	Olfactory_area
GTTAACATCACTTAAA	Olfactory_area
GTTAAGGGTGCGATGT	Olfactory_area
GTTACAATTGGTGACG	Thalamus
GTTACCTACAACTTGC	Hippocampus_area
GTTACGGCCCGACTGC	Isocortex_1
GTTACTTTGGGCCTAG	Thalamus
GTTAGAGTGTGCCGCT	Isocortex_1
GTTATATTATCTCCCT	Hippocampus_area
GTTATCACCTTCTGAA	Isocortex_1
GTTATTAACGTGGGAG	Hippocampus_area
GTTCACAGGAGTCTAG	Thalamus
GTTCATCGTTTGGCTG	Olfactory_area
GTTCCAGTCTGACCAT	Hippocampus_area
GTTCGACAATTGTATA	Hypothalamus
GTTCGCCATAAGTGCC	Thalamus
GTTCGTCTAAAGAACT	Fiber_tracts
GTTCTTCCCTCGATGT	Hippocampus_area
GTTGAACCGGTTCCAT	Thalamus
GTTGAGTCCCGCCGGT	Olfactory_area
GTTGCACGGAGTTTCG	DG
GTTGGATTCAGTGGCT	Isocortex_1
GTTGGATTGAGAACAC	Fiber_tracts
GTTGGATTTGCGTTGG	Thalamus
GTTGGTCATGCTATCC	Cortical_subplate
GTTGTCGTGTTAGTTG	Hippocampus_area
GTTTACGTTCCATCTG	Hippocampus_area
GTTTCATATCGTCGCT	Midbrain
GTTTCCTGGAGGGTGA	DG
GTTTCTGCAGTCTCCC	Hippocampus_area
GTTTGACCAAATCCTA	CA3
GTTTGGCCCAAGTTAT	Striatum
GTTTGGCCGCTCAGCG	Fiber_tracts
GTTTGGGCTTGTGAGC	Cortical_subplate
GTTTGGTAGGGTCAAC	Cortical_subplate
GTTTGGTGATCGGTGC	Hypothalamus
TAAACCCAGGAGGGCA	Midbrain
TAAAGAGCCCGAAACC	Isocortex_2
TAAAGCGGTATTTCCA	Hippocampus_area
TAAAGCGTTAGGAGAA	Isocortex_2
TAAAGCTGCAATAGGG	Isocortex_1
TAAATGAATCCGTTTC	Hippocampus_area
TAACAAAGGGAGAAGC	Hippocampus_area
TAACAGCGTTTGTGCT	Hypothalamus
TAACATACAATGTGGG	Hippocampus_area
TAACATACACGCGATC	Midbrain
TAACCGCCCGCAGTGC	Isocortex_2
TAACCTACCGTCCGAG	Isocortex_1
TAACGCTTTGAGAGCG	Hippocampus_area
TAACTATCGAAGGTCC	Hippocampus_area
TAACTCATCCGCGCGG	Thalamus
TAACTCCATGGAGGCT	Hippocampus_area
TAAGAGGGACAGGGAC	Hypothalamus
TAAGATTTAGCGGGAG	Isocortex_1
TAAGCAGGCGACACGC	Midbrain
TAAGCGCGAATCAAAT	Hypothalamus
TAAGGAACTTGTGGGA	CA1_CA2
TAAGGCAACATAAGAT	Hippocampus_area
TAAGGCATAACATCAA	Hippocampus_area
TAAGGCCCGTCACCCT	Olfactory_area
TAAGGCTGAATCCCTC	Isocortex_2
TAAGGGCCTGTCCGAT	Olfactory_area
TAAGGGCTGGGAGAGG	Midbrain
TAAGTAACATCTTGAC	Thalamus
TAAGTCGCCGAGTATC	Midbrain
TAAGTTGCGACGTAGG	Olfactory_area
TAATAAACAAGGAGAT	Isocortex_1
TAATACACAGTAGTAT	Hippocampus_area
TAATAGAACAGAGTTA	Midbrain
TAATAGGTCACCAGAA	Hypothalamus
TAATAGTGACGACCAG	Fiber_tracts
TAATATTGAAATTCGC	CA1_CA2
TAATCGATCCGTACGT	Isocortex_2
TAATGAAAGACCCTTG	Hippocampus_area
TAATTAGATGGATATG	Isocortex_2
TACAACGCACAACTCA	Thalamus
TACAAGTCTCGTGCAT	Midbrain
TACAGAAACGGTGGGC	Olfactory_area
TACATAGGCATACACC	Midbrain
TACATTTCTAACGTGC	Thalamus
TACCAAATAGCCCAGA	Cortical_subplate
TACCAATAAAGTACCA	Olfactory_area
TACCAGAAGTAGGTTC	Midbrain
TACCAGCTAGGTTTAA	Isocortex_2
TACCAGGAATCCCGTC	Hypothalamus
TACCGCGGACTTGCAG	Isocortex_2
TACCGGCTCACTGCCC	Hippocampus_area
TACCGGTCGTTTCCAT	Thalamus
TACCGTAGGTTAACTA	Cortical_subplate
TACCGTGCCTCGGACC	Cortical_subplate
TACCTACTCCCAGTAT	Cortical_subplate
TACCTCACGCTTGTAC	Hippocampus_area
TACCTCAGTTGTCTGT	Hippocampus_area
TACCTCCACACCAATG	Hypothalamus
TACCTGCTGCACTGTG	Hippocampus_area
TACCTTAAGATTTCCC	Thalamus
TACGAACACGACTTCA	Thalamus
TACGACGCTTGCTGCG	Midbrain
TACGACTGCCTCTTAG	Hippocampus_area
TACGAGAACTTCACGT	Thalamus
TACGATGTTGATCATC	Thalamus
TACGCAGTTCTTTCCT	Thalamus
TACGCCATATTCTAAT	Midbrain
TACGCCGAGGGTACCC	Hypothalamus
TACGCCTCCATTCCGA	Cortical_subplate
TACGCTATAGAAACCT	Hippocampus_area
TACGCTGATAGTTGTA	Hypothalamus
TACGCTGCTGTGTTAA	Hypothalamus
TACGGGATGCTAGCAG	Isocortex_2
TACGTACTAGTGCTGA	Hypothalamus
TACGTGCACTATGCTG	Hippocampus_area
TACGTTTACCGGCAAT	Thalamus
TACTATGGTTCCTCAG	Hippocampus_area
TACTCCTCTAGTTGAC	Hypothalamus
TACTCGGCACGCCGGG	Midbrain
TACTCTCCGAACAAAT	Isocortex_2
TACTCTTTCGTCTTCA	Hippocampus_area
TACTGAACAGATTTAG	Midbrain
TACTGCAATCAATTAC	Hippocampus_area
TACTGGACAGCTCGGC	Midbrain
TACTTGTTAGTAGTCC	Fiber_tracts
TACTTTACTGAGCCGG	Isocortex_2
TACTTTCCGCACGCCA	Midbrain
TAGAAAGGTGGCGCTA	Hippocampus_area
TAGAATTAAGGGCAAC	Isocortex_1
TAGACGAAACGCCAAT	Olfactory_area
TAGACGCCCGTACCGG	Fiber_tracts
TAGACTACCTAGCGTT	Olfactory_area
TAGAGATCATGCAACT	Midbrain
TAGAGCTACGAAGAAC	Fiber_tracts
TAGAGGTTCTACTTGT	Olfactory_area
TAGAGTCTAAGCGAAC	Hippocampus_area
TAGATATGGACTGGAA	Midbrain
TAGATCCGAAGTCGCA	Isocortex_1
TAGATTCAAAGTGCGG	Cortical_subplate
TAGATTCCTGGTTATT	Midbrain
TAGCAACCTGTCACAA	Hippocampus_area
TAGCCATTTCAAAGTC	Fiber_tracts
TAGCCGGCGGTCAGCG	Fiber_tracts
TAGCGTCCGGTGTGGT	Olfactory_area
TAGCGTTGGGTCTTAC	Hippocampus_area
TAGCTAAGTCCGGGAG	CA3
TAGCTAGAAGGCATGA	Hippocampus_area
TAGCTAGTGATGATGG	Hippocampus_area
TAGCTCGCCTGATAAC	Hippocampus_area
TAGGCATGTTACGCCA	Isocortex_2
TAGGGAGCTTGGGATG	Isocortex_2
TAGGGTGTTTCAAGAG	Hippocampus_area
TAGGTCCAAGTAAGGA	Hippocampus_area
TAGGTCGCCGGAACTG	Isocortex_1
TAGGTGACGATAACCT	Olfactory_area
TAGGTGAGCCCTACTC	Midbrain
TAGGTGCTCGCCTAGC	Fiber_tracts
TAGGTGTTCCACAGAT	Cortical_subplate
TAGGTTCGAGTTCGTC	Hippocampus_area
TAGTACCTTAGTGGTC	Hippocampus_area
TAGTAGCTTATACCAG	Hypothalamus
TAGTCCGCAGAGAATG	Thalamus
TAGTCCTGCACTAAGC	Hypothalamus
TAGTCGATCACGGGTT	Isocortex_2
TAGTCTAACAACGAGA	Thalamus
TAGTGAGAAGTGGTTG	Isocortex_1
TAGTGCCCTCCAGAGT	Thalamus
TAGTGTCAGAAACGGC	Hippocampus_area
TAGTTAAGATAGGATA	Isocortex_1
TAGTTTATTCTTGCTT	Fiber_tracts
TATAAATCCACAAGCT	Hippocampus_area
TATAAGTGAGGATAGC	Hippocampus_area
TATACACAGACGCCTT	Hippocampus_area
TATACACGCAAAGTAT	Hippocampus_area
TATACGCGTCATCACT	Olfactory_area
TATACTCATGCGGCAA	Hippocampus_area
TATAGAGTCGCTTGAA	Hippocampus_area
TATAGATGGTCGCAGT	Isocortex_1
TATAGGGTACTCATGA	Midbrain
TATAGTTAGGTGTACT	Hypothalamus
TATATAGGGCTTTACG	Hypothalamus
TATATATCGAGAAATG	Hypothalamus
TATATCCCTGGGAGGA	Isocortex_2
TATATTCGCGTCGATA	Isocortex_2
TATCACAGCACGGGCA	Isocortex_1
TATCACCCAACCGACC	Isocortex_1
TATCCAATTGGTTATC	Olfactory_area
TATCCATATCATGCGA	CA1_CA2
TATCCATCTCGGTTAG	Hypothalamus
TATCCGCACCGTCGGG	Cortical_subplate
TATCCTGCATGGGAAT	Fiber_tracts
TATCGATCTATGCATA	Isocortex_2
TATCGATGATTAAACG	Hippocampus_area
TATCTACAGAGGTAAT	Midbrain
TATCTACCACAGCGGG	Midbrain
TATCTTGCAATACAAC	Midbrain
TATGAAGACAGGTGCG	Hippocampus_area
TATGATCTTCTCTTTA	Olfactory_area
TATGATTCTGCTTGGT	Isocortex_1
TATGCTCCCTACTTAC	Olfactory_area
TATGGAGTTTCTCGTT	Isocortex_2
TATGGATGTGCTACGC	Hippocampus_area
TATGGCCCGGCCTCGC	Midbrain
TATGGGACCGAGCAGG	Thalamus
TATGGGTACGTATCGT	Thalamus
TATGGTCTGAGTAACA	Midbrain
TATGGTTAGTGGGAGA	Olfactory_area
TATGTCAAGACCGACT	Isocortex_2
TATGTCTCATTGTGCC	Fiber_tracts
TATTAACCTGACCGCG	Hippocampus_area
TATTACCATCCTGCTT	Isocortex_2
TATTATGTTTGCCTGC	Midbrain
TATTCAATTCTAATCC	Hippocampus_area
TATTCCACTCAGCTCG	Hippocampus_area
TATTCCGAGCTGTTAT	Olfactory_area
TATTCCGGCAGTCCTA	Isocortex_1
TATTCCTCCGCCCACT	Thalamus
TATTCGTGCCAGAATA	Hippocampus_area
TATTTAGTCTAGATCG	Hippocampus_area
TATTTATACCGAGTAG	Isocortex_2
TATTTGTTACCCTTTA	DG
TCAAACAACCGCGTCG	Hippocampus_area
TCAAACTTAGATTGTT	CA3
TCAAAGTCACGGCGTC	Hypothalamus
TCAAATTTGAGACTCA	Olfactory_area
TCAACAAAGATAATTC	Midbrain
TCAACACATTGGGTAA	Fiber_tracts
TCAACATAGCGCCCTA	Hippocampus_area
TCAACATCGACCGAGA	Midbrain
TCAACCATGTTCGGGC	DG
TCAACGAGGAGACAAA	Hippocampus_area
TCAACGCAGGAAATAA	Thalamus
TCAACGCGACCGGCAG	Midbrain
TCAACTAACGTATAAC	Hippocampus_area
TCAAGGTTACTACACC	Olfactory_area
TCAATACGCCGTCATG	Cortical_subplate
TCACAGCAAACTCGAA	Midbrain
TCACAGGAGAATAAGA	Hippocampus_area
TCACAGGGAATCGCAA	Olfactory_area
TCACAGGTTATTGGGC	Thalamus
TCACATCTTATCTGAT	Hippocampus_area
TCACCCTCTTAAGATT	Hippocampus_area
TCACCGCTCGGCACTC	Isocortex_2
TCACGATGTCCGTGGA	Midbrain
TCACGCATTGTAGATC	Thalamus
TCACGGCCCAAGAGAG	Hypothalamus
TCACGGTCATCGCACA	Hippocampus_area
TCACGTGCCCGATTCA	Midbrain
TCACTCGTGCAACGGC	Isocortex_1
TCAGACGCTATAGAAG	Striatum
TCAGCAAATGCATCTC	Hippocampus_area
TCAGCAGTAGGCCCTG	Hypothalamus
TCAGGGTGTAACGTAA	Hippocampus_area
TCAGGTTCTTTGAGAA	Thalamus
TCAGTACTGACCCGCG	DG
TCAGTAGGGACTATAA	Hippocampus_area
TCAGTGTATACGTCAT	Hypothalamus
TCATACTTACAGATCC	Hippocampus_area
TCATATGAGCTTTGTT	Olfactory_area
TCATCACTCGAGCTCG	Hippocampus_area
TCATCCCAGAGGGTGG	Isocortex_2
TCATCGATGGTCCCAA	Midbrain
TCATGCAGGTTCTCAT	Isocortex_2
TCATTTAAGTCTCCGA	Isocortex_2
TCCAACTTTAAATTCT	Thalamus
TCCAATAAAGGCTACC	Cortical_subplate
TCCACAATGGTTTACG	Thalamus
TCCACCTCTAGCCTTT	Cortical_subplate
TCCACTTTATCTAGGT	Striatum
TCCAGAGCACCGGTTC	Hippocampus_area
TCCAGGCGAGTACGGT	Thalamus
TCCAGGGTATATACGA	Olfactory_area
TCCATCAATACTAATC	Hypothalamus
TCCATTAGTTGGATAG	Isocortex_2
TCCATTGTGACCTCGT	Isocortex_1
TCCCAAAGACGAAGGA	Hippocampus_area
TCCCAGCTTTAGTCTG	Thalamus
TCCCAGGCTTAGCTAA	Thalamus
TCCCGCGTACTCCTGG	CA3
TCCCGGGTGTGCTGCT	Thalamus
TCCCGGTCAGGAATTT	Isocortex_2
TCCCGTCAGTCCCGCA	Fiber_tracts
TCCCGTGTGCAATTTG	Striatum
TCCCTGGCGTATTAAC	Midbrain
TCCCTGGCTCGCTGGA	Midbrain
TCCCTTAGATTACTCG	Isocortex_2
TCCGAACTTGGCTTAC	Midbrain
TCCGACCGCTAATCAA	Hypothalamus
TCCGAGAAGGCTAAGC	Isocortex_1
TCCGATAATTGCCATA	Hippocampus_area
TCCGATGACTGAGCTC	Fiber_tracts
TCCGATGGTGCGACAT	DG
TCCGATTACATTGCCG	Thalamus
TCCGCCTGTCTACAAG	Olfactory_area
TCCGCGGCAGCATCTG	Fiber_tracts
TCCGCGGCCCAATGAA	Olfactory_area
TCCGCTGTCATCCCGG	Olfactory_area
TCCGCTTATCCCATTA	Cortical_subplate
TCCGGCCTAGCGTACA	Isocortex_2
TCCGGTTCGTCCGGTC	Hippocampus_area
TCCGTTAAGCTAATAT	Olfactory_area
TCCGTTTAGCCTTGAA	Fiber_tracts
TCCTAAATTGGGAAGC	Olfactory_area
TCCTAACCGTCGGGCA	Hippocampus_area
TCCTACATCCACGGCC	Olfactory_area
TCCTAGCAAAGAAGCT	Thalamus
TCCTCCTAAGACATTC	Midbrain
TCCTCGGGCTGGGCTT	Striatum
TCCTCTACGAGATGGC	Hippocampus_area
TCCTCTCCAGTTGTCC	Hippocampus_area
TCCTCTGGCCCATTAG	Isocortex_1
TCCTGCCAACTGGAGA	Isocortex_1
TCCTGCGTTGATACTC	Midbrain
TCCTTACGACGGTCCG	Isocortex_2
TCCTTCAGTGGTCGAA	Fiber_tracts
TCCTTTAAATCCGCTT	Olfactory_area
TCCTTTCTTACGCTTA	CA3
TCGAAATTTAGGACCA	Thalamus
TCGAAGAACCGAGCAC	Olfactory_area
TCGAATATCCCGCAGG	Hypothalamus
TCGACAACTGAACCCG	Midbrain
TCGACATAGCGTAGCG	Hypothalamus
TCGAGACCAACACCGT	Hippocampus_area
TCGAGCCAGGCAGGCC	Hypothalamus
TCGATAGGCTAGTCGC	Isocortex_2
TCGCAAAGATGCATTT	Striatum
TCGCACCAGGAGGCAG	Olfactory_area
TCGCATCCCTAAGTGT	Hippocampus_area
TCGCATTCAATGACTT	Isocortex_2
TCGCCGAAGTTGCGTC	Thalamus
TCGCCGGTCGATCCGT	Hippocampus_area
TCGCGTCCAGAAGGTC	Midbrain
TCGCTAAACCGCTATC	Isocortex_2
TCGCTACTGGCTTTGA	Olfactory_area
TCGCTCGATATATTCC	Hippocampus_area
TCGCTGGGCGGATTGT	Hippocampus_area
TCGCTGTGCGTAAATC	Hippocampus_area
TCGCTTTAAACGTTTG	Isocortex_2
TCGGAATGACCATCAA	Hippocampus_area
TCGGAATGCGCTCTGA	Midbrain
TCGGACGCCCAGCCCA	Striatum
TCGGAGAGTATCGGGA	Midbrain
TCGGAGTACATGAGTA	Hippocampus_area
TCGGCGAACCCAAACC	Olfactory_area
TCGGCTTGTATCGACG	Olfactory_area
TCGGGAGACAGCGTAC	Olfactory_area
TCGGGCCGTCGTGGTA	Fiber_tracts
TCGGGTGAAACTGCTA	Isocortex_2
TCGGTCCCGACAATAG	Hypothalamus
TCGGTCCCTGACTCCA	Isocortex_1
TCGTAAGACGACATTG	Hippocampus_area
TCGTATAGTGCAATTA	Fiber_tracts
TCGTATTACCCATTGC	Midbrain
TCGTCAAGTACGCGCA	Hypothalamus
TCGTCACACTGTTAGC	Hippocampus_area
TCGTCCGCTGGCGTCT	Hippocampus_area
TCGTCTTAGGCGTTAA	Olfactory_area
TCGTGTACTATGGATG	Olfactory_area
TCGTGTCACGCTGACA	Midbrain
TCGTTAGGAGTCCCTA	Hippocampus_area
TCGTTCGTTATTATGT	Isocortex_2
TCGTTGCTATCCGGTC	Midbrain
TCGTTGGCTCGTCAAT	Fiber_tracts
TCTAATACTGCCTCAG	Midbrain
TCTACCGTCCACAAGC	Hippocampus_area
TCTAGCAATCTCCGCC	Thalamus
TCTAGCATCTTCGATG	DG
TCTAGCATGCCCAGAA	Cortical_subplate
TCTAGGTGGCGACGCT	Isocortex_1
TCTAGTGATATCGTGG	Isocortex_2
TCTAGTTATCAGAAGA	Thalamus
TCTATCATGCAGTTAC	Hippocampus_area
TCTATCGGTCGCAACA	CA1_CA2
TCTATTACGCTGGCGA	Hippocampus_area
TCTCATGAGATAGGGT	Fiber_tracts
TCTCCAACGTAGGTTA	Fiber_tracts
TCTCCCTGGGCAGCGT	Olfactory_area
TCTCGAACGAGGTCAC	Isocortex_1
TCTCGGCTCCAGGACT	Isocortex_2
TCTCTAATAGCTGGTA	Hippocampus_area
TCTCTTACCGCGAACC	Hypothalamus
TCTGAACCGGTCGGCT	Hippocampus_area
TCTGAACTCGTACCCG	Isocortex_2
TCTGAAGCACGTGGTC	Olfactory_area
TCTGAATTCCGTACAA	Isocortex_2
TCTGATGTATTCTGTC	Olfactory_area
TCTGCCAGAAACTGCA	Striatum
TCTGCGTCCGGTTTCT	Hippocampus_area
TCTGGGAACCTTTGAA	Isocortex_2
TCTGGGTAGCGCTCAT	Thalamus
TCTGTCATACAAGAGC	Isocortex_2
TCTGTGACTGACCGTT	Isocortex_2
TCTGTGCCATCATAGT	Striatum
TCTGTGGCTACATTTC	Olfactory_area
TCTGTTACCCAGCATA	Midbrain
TCTTACAGAGGTACCG	Hippocampus_area
TCTTACCGGAACTCGT	Isocortex_2
TCTTACGGCATCCGAC	Hippocampus_area
TCTTACTTATGCCTCT	Isocortex_2
TCTTAGAGTGAACTCT	Isocortex_2
TCTTCCCATGGGCACA	Isocortex_2
TCTTCGAATAGACGTT	Hippocampus_area
TCTTCGATACCAATAA	CA3
TCTTCTATAACCCGCC	Hippocampus_area
TCTTGATGCGTAGCGA	CA3
TCTTGCTCCCGATACT	Olfactory_area
TCTTGGTAACACCAAA	Hippocampus_area
TCTTTAAGACTATGAA	Isocortex_2
TCTTTCTCTTAAGGAG	Isocortex_1
TGAAACTTATGCAAGC	Isocortex_2
TGAAAGGACCTGACTC	Striatum
TGAACAAGCAGGGACT	Hypothalamus
TGAATGAGTGTTTCCC	Hippocampus_area
TGACATCGAGCGGACC	Isocortex_1
TGACCAAATCTTAAAC	Olfactory_area
TGACCCACGTTAGACA	Thalamus
TGACGAATATTTCCCT	Midbrain
TGACGATGCACTAGAA	Isocortex_2
TGACTATAATCCTTTC	Hippocampus_area
TGACTCCGAATCATAC	Hypothalamus
TGAGAATGCTTTACCG	CA1_CA2
TGAGAGATTTACCACG	Fiber_tracts
TGAGATCAAATACTCA	Isocortex_1
TGAGATTAGGCCCTAA	Isocortex_1
TGAGCAGTCGTGAAGT	Isocortex_1
TGAGCCATACAGTCTC	Thalamus
TGAGCGGAAAGTGTTC	Cortical_subplate
TGAGCTTTAATGACGC	Isocortex_2
TGAGGAGTGCCAGCTT	Cortical_subplate
TGAGTAAATTAGCGTA	Hippocampus_area
TGAGTGCCTCTTAAAT	Thalamus
TGAGTGGTCCGTGACG	Fiber_tracts
TGATACATTTAGCCGT	Midbrain
TGATCAGGGAACTGCT	Midbrain
TGATCGGTTTGACCCT	CA3
TGATCTCCGGCGCCAG	Hippocampus_area
TGATTCCCGGTTACCT	Cortical_subplate
TGATTCGTCTATCACT	Thalamus
TGATTCTGTCGCCGGT	Midbrain
TGATTTATTAGCTGTG	Thalamus
TGATTTCCTCCTGACG	Hippocampus_area
TGCAACCCATCTGCGG	Olfactory_area
TGCAAGAATGACGTAA	CA3
TGCACGAGTCGGCAGC	Isocortex_1
TGCAGAACTATATCGT	Midbrain
TGCAGAGTACCGAGCA	Thalamus
TGCAGATCGTCCTAGG	Midbrain
TGCAGCTACGTACTTC	Midbrain
TGCAGGATCGGCAAAG	Hippocampus_area
TGCAGTGGTAGGGAAC	Hypothalamus
TGCAGTTTCCTCCCAT	Fiber_tracts
TGCATATGTCTGTCAC	Fiber_tracts
TGCATGGATCGGATCT	Hippocampus_area
TGCATGTGGTAATCTA	Fiber_tracts
TGCCAAAGTCAGACTT	Midbrain
TGCCAATGGGTACTCT	Hippocampus_area
TGCCACCTGGCGAAAC	Fiber_tracts
TGCCAGTACGTGGAGA	Cortical_subplate
TGCCATTACTAAAGAA	Isocortex_2
TGCCCGTACCGTTAAA	Striatum
TGCCGGATGTACGAGC	Hypothalamus
TGCCGTGGATCGTCCT	Cortical_subplate
TGCCTGACATCGGTCA	Isocortex_2
TGCCTGATCAAACGAT	Hippocampus_area
TGCCTTGGCCAGGCAA	Olfactory_area
TGCGACACCCTAGTGC	Thalamus
TGCGACGGCCGAACGT	Hypothalamus
TGCGAGAATATTACCC	Midbrain
TGCGCAAAGCATTTGG	CA3
TGCGCGATTAACGGAG	Hippocampus_area
TGCGGAGTAAAGGTGC	Hippocampus_area
TGCGGCATAGTTCAAC	Isocortex_2
TGCGGTGAAATTTCAT	Isocortex_2
TGCGTAAGAACCTGAT	Thalamus
TGCGTCATGACTGAGC	Midbrain
TGCGTGATTGGGTGTC	Hippocampus_area
TGCGTTTGTTGACACT	Striatum
TGCTAAGTGTCTATTT	Fiber_tracts
TGCTATACAAACGGAC	Isocortex_1
TGCTATGGCAAAGGGA	Hypothalamus
TGCTCCACAGTTCTTA	Isocortex_2
TGCTCGGCGAAACCCA	Cortical_subplate
TGCTCGGTGGGTCACC	Olfactory_area
TGCTCTTGAGAGTTTG	Olfactory_area
TGCTGGTTGGACAATT	Hippocampus_area
TGCTGTTGAAGAACTC	Hippocampus_area
TGCTTAGAGAGAATGC	Hypothalamus
TGCTTCCCAAGCAGTA	Olfactory_area
TGCTTGAAACCATGCA	Isocortex_2
TGGAAGAAGGGAACGT	Thalamus
TGGAAGACGAACACCA	Hippocampus_area
TGGAAGGATAAAGATG	Hippocampus_area
TGGAATTAGACGCTTT	Hippocampus_area
TGGACCAATCTAAGAT	Olfactory_area
TGGACCACGGCGTTGA	Isocortex_2
TGGACGCAATCCAGCC	Hypothalamus
TGGACTGTTCGCTCAA	Hippocampus_area
TGGAGCTAAAGTTCCC	Isocortex_1
TGGAGTGATGCGATGA	Thalamus
TGGCAAACTAAATTAC	Olfactory_area
TGGCAACTCGCGCGCC	Isocortex_2
TGGCAAGCACAAGTCG	Cortical_subplate
TGGCAGATTACGATCA	Midbrain
TGGCAGCAGTAATAGT	Midbrain
TGGCCAAACTGAAGTA	Hippocampus_area
TGGCCGTATATTGACC	Hippocampus_area
TGGCGACTGCTCCAAA	Hippocampus_area
TGGCGATCAAGTTATG	Hippocampus_area
TGGCGGTGTGCGATTG	Isocortex_2
TGGCTATGTGACATAC	Olfactory_area
TGGCTTTGGGTAGACA	Hippocampus_area
TGGGAAATGCCTTTCC	CA1_CA2
TGGGCACAAACAGAAC	Isocortex_2
TGGGCACGTTCTATGG	Isocortex_2
TGGGCCACAAGAGCGC	Fiber_tracts
TGGGCCCATACTAATT	Fiber_tracts
TGGGCGATACAATAAG	Hippocampus_area
TGGGTAAGGTTCCCGC	Isocortex_2
TGGGTTTCGGGCGTAC	Hypothalamus
TGGTAGAATATATGGG	Olfactory_area
TGGTATCGCATCCCAA	Isocortex_1
TGGTATCGGTCTGTAT	Isocortex_1
TGGTCCCACGCTACGG	Olfactory_area
TGGTCTGTTGGGCGTA	Midbrain
TGGTTCAACGGGTAAT	Olfactory_area
TGGTTCGTAGCAAAGG	Hippocampus_area
TGGTTGGAGGATCCTG	Isocortex_1
TGTACCTACACGAGGG	Olfactory_area
TGTACGAACAAATCCG	Midbrain
TGTACTGTGCCAAAGT	Isocortex_1
TGTAGGAGAAATTTCC	Fiber_tracts
TGTAGTGATCTATAAT	Thalamus
TGTATAACAGATCCTG	Hippocampus_area
TGTATCCTTATTCCAT	Isocortex_2
TGTATGGCGCAGACAG	Isocortex_2
TGTCCCGACATAGCAC	Isocortex_2
TGTCCGTGGCGCCTTT	Hippocampus_area
TGTCCTAAGTCACCGC	Midbrain
TGTCGGCATGGTGGAA	Isocortex_2
TGTCGTTATCACATAT	Hypothalamus
TGTCTACAGTTTCTGT	Isocortex_2
TGTGACTACGCCAGTC	Fiber_tracts
TGTGAGACTAGCCCAA	Olfactory_area
TGTGCCGGTGCCGGAA	Olfactory_area
TGTGCTTTACGTAAGA	Midbrain
TGTGGCAAAGCGTATG	Fiber_tracts
TGTGGCGGGCTTCTGG	Cortical_subplate
TGTGGTTGCTAAAGCT	Hippocampus_area
TGTGTCGCGAGTTGCA	DG
TGTGTTCGTATCCAAG	Hippocampus_area
TGTTATTGTATGTGGC	Olfactory_area
TGTTCCGCTTCCATGA	Thalamus
TGTTCGTATTGCGGTG	Hippocampus_area
TGTTCTTCCATTGACT	Thalamus
TGTTGTCAAGAAGTCT	Fiber_tracts
TGTTTAATACTTCATC	Isocortex_1
TGTTTCGGTACTTCTC	Hippocampus_area
TTAAACAGAGTCCCGC	Fiber_tracts
TTAAACCGGTAGCGAC	Isocortex_2
TTAAACTCGAATTCAT	Isocortex_2
TTAACACCTCGAACAT	CA1_CA2
TTAACCAACCCTCCCT	CA1_CA2
TTAACGTCGCAAGACC	Isocortex_2
TTAACTTCAGGTAGGA	Midbrain
TTAAGATAGGATTGAC	Isocortex_1
TTAAGCCGACAACTTC	Isocortex_2
TTAAGCGCCTGACCCA	Thalamus
TTAAGGATACGGAGGT	Isocortex_2
TTAAGGCCCGTACTTT	Hypothalamus
TTAATCAGTACGTCAG	Fiber_tracts
TTAATGTAGACCAGGT	CA3
TTAATTGCTTTGGGTG	Olfactory_area
TTAATTTCAGACGCGG	Fiber_tracts
TTACAACTACGCATCC	Hippocampus_area
TTACAGACCTAAATGA	Isocortex_2
TTACATCGTGGCCTGG	Hippocampus_area
TTACATGCCACAACTA	Isocortex_1
TTACCATTGATTACCC	Midbrain
TTACCCATTGCCGGGT	Isocortex_2
TTACCCTAACAGTCCT	CA1_CA2
TTACCCTAGGGATTGG	Cortical_subplate
TTACCGCCTTAGGGAA	Isocortex_2
TTACGGATGGTTCGAG	Isocortex_2
TTACGGTGTCACCGAG	Isocortex_1
TTACTAAAGGACTTTA	Olfactory_area
TTACTATCGGCTTCTC	Midbrain
TTACTCCGGCCGGGAA	Hippocampus_area
TTACTCTGGTACGTAC	Midbrain
TTACTGGGATATTTCA	Midbrain
TTAGAAGAACATGACT	Cortical_subplate
TTAGAATAAGGGTCGG	Midbrain
TTAGACACGATCGTTG	Isocortex_2
TTAGACGAGTCACCTC	Olfactory_area
TTAGAGTTTAGAAGGA	Olfactory_area
TTAGATAGGTCGATAC	Isocortex_2
TTAGCAACATGGATGT	Hippocampus_area
TTAGCTAATACGATCT	Isocortex_1
TTAGCTGATTTGCCGT	Isocortex_2
TTAGGTCATAACCGAC	Hypothalamus
TTAGTAGGGCGGCGGG	Midbrain
TTAGTTATTCGTGGCA	Fiber_tracts
TTATAGATGCACATTA	Isocortex_1
TTATAGGTAATTGTCT	Olfactory_area
TTATATACGCTGTCAC	Hippocampus_area
TTATATTTGGCAATCC	Hippocampus_area
TTATCCAATCGAACTC	Fiber_tracts
TTATCCGGGATCTATA	Fiber_tracts
TTATCCTCAAGGAATA	Midbrain
TTATCGCCTGCGAAGC	Hippocampus_area
TTATCTGTATCATAAC	Hippocampus_area
TTATGAATGAAAGGGA	Hippocampus_area
TTATGACAAACTGGAT	Hippocampus_area
TTATGATCTTAACGAA	Striatum
TTATGCGTCCCGGTCC	Isocortex_2
TTATGTTTGCGATAGA	Hippocampus_area
TTATTAGAGCGTGTTC	Hippocampus_area
TTATTAGGGAAGCATC	Fiber_tracts
TTCAAAGTCTCTAGCC	Hippocampus_area
TTCAACGACCCGACCG	Hippocampus_area
TTCAAGCCGAGCTGAG	Isocortex_2
TTCAATACTCTGAATC	Fiber_tracts
TTCAATTAGCCATAAT	Isocortex_1
TTCACGAAAGGATCAC	Thalamus
TTCACGGTCGTCACGT	Hypothalamus
TTCACTCGAGCACCTA	Olfactory_area
TTCAGAGTAACCTGAC	Isocortex_2
TTCAGCCCTGGTCCAC	Olfactory_area
TTCAGCTGGCGTGCCC	Olfactory_area
TTCAGGCGTCAAAGCC	Midbrain
TTCATGGCGCAACAGG	Fiber_tracts
TTCCAATCAGAGCTAG	Isocortex_1
TTCCAATCTGGCTATC	Midbrain
TTCCACACAGATTTGA	Midbrain
TTCCGCGTGAGGCGAT	Hippocampus_area
TTCCGGCCTTGAGGCT	Midbrain
TTCCGGTTACCCACTT	Olfactory_area
TTCCTCGAGGGTGTCT	Hippocampus_area
TTCCTCGGACTAACCA	Olfactory_area
TTCCTTTCTGTGTTGC	Fiber_tracts
TTCGACAGAGCCCGTG	Cortical_subplate
TTCGACGGGAAGGGCG	DG
TTCGCACTCGCGTGCT	CA3
TTCGCACTGTACGACA	Cortical_subplate
TTCGCATCCGGAAGCA	Isocortex_2
TTCGCGCGCCATACGA	Hippocampus_area
TTCGCTATCTGACGTG	Hippocampus_area
TTCGGCAACCCGCTGA	Isocortex_2
TTCGGCTAGAGATGGT	Hippocampus_area
TTCGGGACTAATCGCG	Hippocampus_area
TTCGGGCGCTAGTCTT	Hypothalamus
TTCGGTACTGTAGAGG	Olfactory_area
TTCGTAATCCCAGCGG	Isocortex_1
TTCGTACTCCAGAACG	Midbrain
TTCTAACCGAAGCTTA	Fiber_tracts
TTCTACCTCAATCGGT	Hypothalamus
TTCTACTTGCGAGGGC	Hippocampus_area
TTCTAGAAAGTCTTAT	Hippocampus_area
TTCTAGGCCAATTGTG	Hippocampus_area
TTCTATTAAACGCAGC	Hippocampus_area
TTCTCAATTGCTACAA	Hypothalamus
TTCTGACCGGGCTCAA	Olfactory_area
TTCTGCCGCGCCTAGA	Cortical_subplate
TTCTGCGAGCGCCCTT	Midbrain
TTCTGCGGGTTAGCGG	Striatum
TTCTTAGTGAACGGTG	CA1_CA2
TTCTTAGTGGCTCAGA	Hippocampus_area
TTCTTATCCGCTGGGT	Olfactory_area
TTCTTGAGCCGCGCTA	Thalamus
TTCTTGGACGATCTGC	Midbrain
TTCTTGGAGTAATGAG	Fiber_tracts
TTCTTGTAACCTAATG	Hippocampus_area
TTGAACGAATCCTTTG	Hippocampus_area
TTGAACGACGTGCTGA	Olfactory_area
TTGAAGAATTCCCAGG	Thalamus
TTGAATATGGACTTTC	Hippocampus_area
TTGAATTCACGTGAGG	Isocortex_2
TTGACAGGAGCTCCCG	Olfactory_area
TTGACATGAACGTGGA	Thalamus
TTGACCAGGAACAACT	Olfactory_area
TTGACCATGTTCTCCG	Fiber_tracts
TTGACCGTGTTAATGA	Hippocampus_area
TTGACGATTCAGCACG	Isocortex_2
TTGACGCTCCATGAGC	Isocortex_1
TTGACTACCATATGGT	Thalamus
TTGACTATTGTCCGGC	Olfactory_area
TTGAGAAGTTTAGCAT	Olfactory_area
TTGAGAGTACTGCTAA	Thalamus
TTGATCTAACTTTGTC	Thalamus
TTGATGCCGCTCGTCG	Hypothalamus
TTGATGTGTAGTCCCG	Isocortex_2
TTGATTAGCTGTTTCT	Thalamus
TTGATTATGCAGATGA	Hippocampus_area
TTGCACAATTCAGAAA	Midbrain
TTGCACGGAGCAGCAC	Hippocampus_area
TTGCATGCTGATCACG	Thalamus
TTGCCATAGCCCGCTC	Midbrain
TTGCCCTGATCACGGG	Thalamus
TTGCCGCAGACCTACA	Hypothalamus
TTGCCGCTTTCTAGTA	Olfactory_area
TTGCCTAATCCAAAGT	Hypothalamus
TTGCGGCATCAGAAAG	Midbrain
TTGCGTAGTTTGAGGA	Hippocampus_area
TTGCGTCGGCCAACCG	Midbrain
TTGCTCCCATACCGGA	Hippocampus_area
TTGCTGAAGGAACCAC	CA1_CA2
TTGCTGATCATGTTCG	Thalamus
TTGCTGCACCTATCCA	Hippocampus_area
TTGCTGGCCGGGCTTC	Isocortex_1
TTGGAAGAATACAGTC	Thalamus
TTGGACATGTGGCTTA	Midbrain
TTGGACCATCTGGCAA	Olfactory_area
TTGGACCTATAACAGT	Olfactory_area
TTGGAGTCTCCCTTCT	Isocortex_2
TTGGATATCGTCTACG	Hippocampus_area
TTGGATCGACTTCTGG	Isocortex_2
TTGGATTGGGTACCAC	Hippocampus_area
TTGGCCATCTTGCGCT	Hippocampus_area
TTGGCCTAGAATTTCG	Isocortex_2
TTGGCTCGCATGAGAC	Hippocampus_area
TTGGGAAGACGAGCCG	Hippocampus_area
TTGGGACACTGCCCGC	CA3
TTGGGCGGCGGTTGCC	Hippocampus_area
TTGGTCACACTCGTAA	Midbrain
TTGGTTGCGGTGCGCG	Midbrain
TTGTAAGGACCTAAGT	Thalamus
TTGTAAGGCCAGTTGG	Fiber_tracts
TTGTAATCCGTACTCG	Thalamus
TTGTATCACACAGAAT	Isocortex_2
TTGTCGTTCAGTTACC	Hippocampus_area
TTGTGAACCTAATCCG	Olfactory_area
TTGTGCAGCCACGTCA	Olfactory_area
TTGTGGCCCTGACAGT	Hippocampus_area
TTGTGGTAGGAGGGAT	Thalamus
TTGTGTATGCCACCAA	Cortical_subplate
TTGTGTTTCCCGAAAG	Hippocampus_area
TTGTTAGCAAATTCGA	Olfactory_area
TTGTTCAGTGTGCTAC	Hippocampus_area
TTGTTGTGTGTCAAGA	Hippocampus_area
TTGTTTCACATCCAGG	Hypothalamus
TTGTTTCATTAGTCTA	Hypothalamus
TTGTTTCCATACAACT	Midbrain
TTGTTTGTGTAAATTC	Isocortex_1
